"Lenovo IdeaPad S340 10th Gen Intel Core i3/ 14 inch Full HD IPS Thin and Light Laptop (8 GB/256 GB SSD/Windows 10/MS Office 2019/Platinum Grey/1.6 Kg), 81VV00JFIN",801,575,226,none,/lenovo-ideapad-s340-10th-gen-intel-core-i3-14-inch-full-hd-ips-thin-and-light-laptop-8-gb-256-gb-ssd-windows-10-ms-office-2019-platinum-grey-1-6-kg-81vv00jfin-CMPLXLAPLENOVO-IDEAPUNBO867328BCA95976-pdp?product_id=333294515&src=consumer_search-grid&svc=-1&tracker=%7C%7C%7C%7C%2Fg%2Felectronics%2Flaptop-computers%2Flaptops-glpid-6453%7C6453%7C1%7C%7C%7C%7C&get_review_id=333294517
Dell Inspiron 15 3593 15.6-inch FHD Laptop (10th Gen Core i3/8GB/1TB HDD + 256SSD/Windows 10 + MS Office/Intel HD Graphics/Silver),670,658,12,none,/dell-inspiron-15-3593-15-6-inch-fhd-laptop-10th-gen-core-i3-8gb-1tb-hdd-+-256ssd-windows-10-+-ms-office-intel-hd-graphics-silver-CMPLXLAPDELL-INSPIRODUMM20256C35748B6-pdp?product_id=333070710&src=consumer_search-grid&svc=-1&tracker=%7C%7C%7C%7C%2Fg%2Felectronics%2Flaptop-computers%2Flaptops-glpid-6453%7C6453%7C2%7C%7C%7C%7C&get_review_id=330457809
HP 245 G7 Laptop 2D5Y6PA (AMD Ryzen 5-3500U/4GB Ram/ 1TB HDD/ 14.0 inch HD /DOS/AMD Radeon Vega 8 Graphics/ Dark Ash Silver/1.52Kg),507,491,16,none,/hp-245-g7-laptop-2d5y6pa-amd-ryzen-5-3500u-4gb-ram-1tb-hdd-14-0-inch-hd-windows-10-amd-radeon-vega-8-graphics-dark-ash-silver-1-52kg-CMPLXLAPHP-245-G7-LADUMM20256FB790299-pdp?product_id=337897348&src=consumer_search-grid&svc=-1&tracker=%7C%7C%7C%7C%2Fg%2Felectronics%2Flaptop-computers%2Flaptops-glpid-6453%7C6453%7C3%7C%7C%7C%7C&get_review_id=332593887
"Microsoft Surface Laptop 3 (Intel Core i5/ 8 GB/ 128 GB SSD/ 34.29 cm (13.5 inch)/ Windows 10) 1867 (Platinum , 1.26 kg)",1438,1384,54,none,/microsoft-surface-laptop-3-intel-core-i5-8-gb-128-gb-ssd-34-29-cm-13-5-inch-windows-10-1867-platinum-1-26-kg-CMPLXLAPMICROSOFT-SUSUPE46222B0A06212-pdp?product_id=333472494&src=consumer_search-grid&svc=-1&tracker=%7C%7C%7C%7C%2Fg%2Felectronics%2Flaptop-computers%2Flaptops-glpid-6453%7C6453%7C4%7C%7C%7C%7C&get_review_id=330483992
Mi Notebook Horizon Edition 14 Intel Core i7-10510U 10th Gen Thin and Light Laptop(8GB/512GB SSD/Windows 10/Nvidia MX350 2GB Graphics/Grey/1.35Kg) XMA1904-AF+Webcam,904,863,41,none,/mi-notebook-horizon-edition-14-intel-core-i5-10510u-10th-gen-thin-and-light-laptop-8gb-512gb-ssd-windows-10-nvidia-mx350-2gb-graphics-grey-1-35kg-xma1904-af+webcam-CMPLXLAPMI-NOTEBOOK-DUMM20256DFD12B9D-pdp?product_id=333550928&src=consumer_search-grid&svc=-1&tracker=%7C%7C%7C%7C%2Fg%2Felectronics%2Flaptop-computers%2Flaptops-glpid-6453%7C6453%7C5%7C%7C%7C%7C&get_review_id=333550929
"Asus Vivobook X509JA-BQ839T Intel Core i5 10th Gen 8 GB 1 TB 39.62 cm (15.6 inch) Silver, 1.8 kg",753,644,109,none,/asus-vivobook-x509ja-bq839t-intel-core-i5-10th-gen-8-gb-1-tb-39-62-cm-15-6-inch-silver-1-8-kg-CMPLXLAPASUS-VIVOBOODUMM20256EBE7A814-pdp?product_id=333937887&src=consumer_search-grid&svc=-1&tracker=%7C%7C%7C%7C%2Fg%2Felectronics%2Flaptop-computers%2Flaptops-glpid-6453%7C6453%7C6%7C%7C%7C%7C&get_review_id=332412129
"Acer Aspire 3 A315-57G Thin and Light Laptop (Intel Core i5-10th Gen/8 GB RAM/1 TB HDD/39.62 cm (15.6 inch)/FHD/Windows 10 Home/NVIDIA GeForce MX330 Graphics) NX.HZRSI.001 (Charcoal Black, 1.9 kg)",849,726,123,none,/acer-aspire-3-a315-57g-thin-and-light-laptop-intel-core-i5-10th-gen-8-gb-ram-1-tb-hdd-39-62-cm-15-6-inch-fhd-windows-10-home-nvidia-geforce-mx330-graphics-nx-hzrsi-001-charcoal-black-1-9-kg-CMPLXLAPACER-ASPIRE-DUMM20256A47FB90-pdp?product_id=334005544&src=consumer_search-grid&svc=-1&tracker=%7C%7C%7C%7C%2Fg%2Felectronics%2Flaptop-computers%2Flaptops-glpid-6453%7C6453%7C7%7C%7C%7C%7C&get_review_id=334005545
Lenovo Ideapad S145  (AMD Ryzen 5-3500U/8GB /1TB HDD/15.6 inch Full HD/Win 10/MS Office 2019/Integrated AMD Radeon Vega 8 Graphics/Platinum Grey/1.85Kg)  81UT00JBIN,890,586,304,none,/lenovo-ideapad-s145-amd-ryzen-5-3500u-8gb-1tb-hdd-15-6-inch-full-hd-win-10-ms-office-2019-integrated-amd-radeon-vega-8-graphics-platinum-grey-1-85kg-81ut00jbin-CMPLXLAPLENOVO-IDEAPLOWE541476DA3FECC3-pdp?product_id=337328493&src=consumer_search-grid&svc=-1&tracker=%7C%7C%7C%7C%2Fg%2Felectronics%2Flaptop-computers%2Flaptops-glpid-6453%7C6453%7C8%7C%7C%7C%7C&get_review_id=332588620
"HP Pavilion x360 14-dh1180tu (Intel Core i7-10510U(10th Gen)/8 GB RAM/512 GB SSD/35.56 cm (14 inch)/Windows 10 Home/Intel UHD Graphics) (Mineral Silver, 1.58 kg)",1281,1151,130,none,/hp-pavilion-x360-14-dh1180tu-intel-core-i7-10510u-10th-gen-8-gb-ram-512-gb-ssd-35-56-cm-14-inch-windows-10-home-intel-uhd-graphics-mineral-silver-1-58-kg-CMPLXLAPHP-PAVILION-GREE3950879F1DCF38-pdp?product_id=333164041&src=consumer_search-grid&svc=-1&tracker=%7C%7C%7C%7C%2Fg%2Felectronics%2Flaptop-computers%2Flaptops-glpid-6453%7C6453%7C9%7C%7C%7C%7C&get_review_id=332078038
"Dell Inspiron 15 3593 15.6-inch FHD Laptop (10th Gen Core i3/8GB/1TB HDD/Windows 10 + MS Office 2019/Intel HD Graphics)(Black, 2.02 Kg)",644,600,44,none,/dell-inspiron-15-3593-15-6-inch-fhd-laptop-10th-gen-core-i3-8gb-1tb-hdd-windows-10-+-ms-office-2019-intel-hd-graphics-black-2-02-kg-CMPLXLAPDELL-INSPIRODUMM2025612075D5F-pdp?product_id=333157301&src=consumer_search-grid&svc=-1&tracker=%7C%7C%7C%7C%2Fg%2Felectronics%2Flaptop-computers%2Flaptops-glpid-6453%7C6453%7C10%7C%7C%7C%7C&get_review_id=330930086
"Asus ROG Zephyrus G14 (AMD Ryzen 9/16 GB RAM/1 TB SSD/35.56 cm (14 inch)/Windows 10) GA401IV-HA181TS (Eclipse Grey with AniMe Matrix , 1.7 kg)",2671,1959,712,none,/asus-rog-zephyrus-g14-amd-ryzen-9-16-gb-ram-1-tb-ssd-35-56-cm-14-inch-windows-10-ga401iv-ha181ts-eclipse-grey-with-anime-matrix-1-7-kg-CMPLXLAPASUS-ROG-ZEPASUS20915DE5CF63A-pdp?product_id=332466707&src=consumer_search-grid&svc=-1&tracker=%7C%7C%7C%7C%2Fg%2Felectronics%2Flaptop-computers%2Flaptops-glpid-6453%7C6453%7C11%7C%7C%7C%7C&get_review_id=332466715
Microsoft Surface Pro 7   31.24 cm (12.3 inch) Touch-Screen - Intel Core i5 - 8GB Memory - 128GB Solid State Drive (Latest Model)   Platinum Without Keyboard,1288,1068,220,none,/microsoft-surface-pro-7-31-24-cm-12-3-inch-touch-screen-intel-core-i5-8gb-memory-128gb-solid-state-drive-latest-model-platinum-without-keyboard-CMPLXLAPMICROSOFT-SUSUPE4622243DBEE10-pdp?product_id=317295030&src=consumer_search-grid&svc=-1&tracker=%7C%7C%7C%7C%2Fg%2Felectronics%2Flaptop-computers%2Flaptops-glpid-6453%7C6453%7C12%7C%7C%7C%7C&get_review_id=317295032
Lenovo IdeaPad Slim 5i 11th Gen Intel Core i5 15.6-inch Full HD IPS Thin and Light Laptop (8GB/1TB HDD + 256GB SSD/Windows 10/MS Office 2019/Integrated Intel(Graphite Grey/1.66Kg) 82FG00BQIN,1264,822,442,none,/lenovo-ideapad-slim-5i-11th-gen-intel-core-i5-15-6-inch-full-hd-ips-thin-and-light-laptop-8gb-1tb-hdd-+-256gb-ssd-windows-10-ms-office-2019-integrated-intel-graphite-grey-1-66kg-82fg00bqin-CMPLXLAPLENOVO-IDEAPLOWE5414763B734456-pdp?product_id=333942637&src=consumer_search-grid&svc=-1&tracker=%7C%7C%7C%7C%2Fg%2Felectronics%2Flaptop-computers%2Flaptops-glpid-6453%7C6453%7C13%7C%7C%7C%7C&get_review_id=333942639
"HP Pavilion x360 14-dh1178tu (Intel Core i3-10110U(10th Gen)/8 GB RAM/512 GB SSD/35.56 cm (14 inch)/Windows 10 Home/Intel UHD Graphics) (Mineral Silver, 1.58 kg)",863,740,123,none,/hp-pavilion-x360-14-dh1178tu-intel-core-i3-10110u-10th-gen-8-gb-ram-512-gb-ssd-35-56-cm-14-inch-windows-10-home-intel-uhd-graphics-mineral-silver-1-58-kg-CMPLXLAPHP-PAVILION-DUMM202564D36AB88-pdp?product_id=332188095&src=consumer_search-grid&svc=-1&tracker=%7C%7C%7C%7C%2Fg%2Felectronics%2Flaptop-computers%2Flaptops-glpid-6453%7C6453%7C14%7C%7C%7C%7C&get_review_id=332078041
"Dell Latitude 3410 10th Gen Intel Core i3- 10110U (4 GB DDR4 RAM, 1TB HDD, 35.56 cm (14 inch) HD (1366 x 768)  Anti-Glare, Ubuntu, N001I3410001IN9 (Black, 1.61 kg))",815,493,322,none,/dell-latitude-3410-10th-gen-intel-core-i3-10110u-4-gb-ddr4-ram-1tb-hdd-35-56-cm-14-inch-hd-1366-x-768-anti-glare-ubuntu-n001i3410001in9-black-1-61-kg-CMPLXLAPDELL-LATITUDDUMM20256C17461D1-pdp?product_id=333194548&src=consumer_search-grid&svc=-1&tracker=%7C%7C%7C%7C%2Fg%2Felectronics%2Flaptop-computers%2Flaptops-glpid-6453%7C6453%7C15%7C%7C%7C%7C&get_review_id=332494897
"Asus M515DA-EJ001T Laptop (AMD Athlon Silver 3050U @2.3GHz / 4GB Ram/ 1TB HDD/ 15.6"" FHD/ Windows 10 Home/ Fingerprint/ Grey/ 1.9 Kg/ No ODD) Without Optical Drive",452,370,82,none,/asus-m515da-ej001t-laptop-amd-athlon-silver-3050u-2-3ghz-4gb-ram-1tb-hdd-15-6-fhd-windows-10-home-fingerprint-grey-1-9-kg-no-odd-without-optical-drive-CMPLXLAPASUS-M515DA-DUMM20256A061D940-pdp?product_id=337221805&src=consumer_search-grid&svc=-1&tracker=%7C%7C%7C%7C%2Fg%2Felectronics%2Flaptop-computers%2Flaptops-glpid-6453%7C6453%7C16%7C%7C%7C%7C&get_review_id=334016898
"HP 1 5 Ryzen 3 7th Gen -( AMD Ryzen 4GB RAM / 1TB HDD / Windows 10 ) 15-db1069AU (39.62 cm (15.6 inch),Black,1.7)",486,440,46,none,/hp-1-5-ryzen-3-7th-gen-amd-ryzen-4gb-ram-1tb-hdd-windows-10-15-db1069au-39-62-cm-15-6-inch-black-1-7-CMPLXLAPHP-1-5-RYZENK-RE724635F5A92F3F-pdp?product_id=312305485&src=consumer_search-grid&svc=-1&tracker=%7C%7C%7C%7C%2Fg%2Felectronics%2Flaptop-computers%2Flaptops-glpid-6453%7C6453%7C17%7C%7C%7C%7C&get_review_id=312305487
Lenovo ThinkPad E14 Intel Core i3 10th Gen 14-inch Full HD Thin and Light Laptop (4GB RAM/ 1TB HDD/ DOS/ Black/ 1.77 kg)  20RAS0D800,562,529,33,none,/lenovo-thinkpad-e14-intel-core-i3-10th-gen-14-inch-full-hd-thin-and-light-laptop-4gb-ram-1tb-hdd-dos-black-1-77-kg-20ras0d800-CMPLXLAPLENOVO-THINKE-TE22231BE8D0E79-pdp?product_id=330723675&src=consumer_search-grid&svc=-1&tracker=%7C%7C%7C%7C%2Fg%2Felectronics%2Flaptop-computers%2Flaptops-glpid-6453%7C6453%7C18%7C%7C%7C%7C&get_review_id=330446137
"DELL Inspiron 3593 (Intel Core i5-1035G1(10th Gen)/8 GB/1 TB HDD + 256 GB SSD/39.62 cm (15.6 inch)/Windows 10/2 GB NVIDIA MX 230 Graphics) (Platinum Silver, 2.2 kg)",1096,916,180,none,/dell-inspiron-3593-15-6-inch-laptop-10th-gen-ci5-1035g1-8gb-1tb-hdd-+-256gb-ssd-windows-10-2gb-nvidia-mx-230-graphics-platinum-silver-CMPLXLAPDELL-INSPIRODUMM20256941F8DA9-pdp?product_id=332976120&src=consumer_search-grid&svc=-1&tracker=%7C%7C%7C%7C%2Fg%2Felectronics%2Flaptop-computers%2Flaptops-glpid-6453%7C6453%7C19%7C%7C%7C%7C&get_review_id=330457815
HP Envy x360 (AMD Ryzen 5- 3rd Gen /8 GB RAM /512 GB SSD /33.78 cm (13.3 inch) /Windows 10) 13-ay0045AU (Night Fall Black   1.32 kg),1255,1014,241,none,/hp-envy-x360-amd-ryzen-5-3rd-gen-8-gb-ram-512-gb-ssd-33-78-cm-13-3-inch-windows-10-13-ay0045au-night-fall-black-1-32-kg-CMPLXLAPHP-ENVY-X360DUMM2025663ACCE7F-pdp?product_id=333243371&src=consumer_search-grid&svc=-1&tracker=%7C%7C%7C%7C%2Fg%2Felectronics%2Flaptop-computers%2Flaptops-glpid-6453%7C6453%7C20%7C%7C%7C%7C&get_review_id=333243372
"Lenovo V15 (AMD Ryzen 3- 3rd Gen/ 4 GB RAM/ 1 TB HDD/ 39.62 cm (15.6 inch) / DOS) 82C70016IH (Iron Grey, 1.85 kg)",469,384,85,none,/lenovo-v15-amd-ryzen-3-3rd-gen-4-gb-ram-1-tb-hdd-39-62-cm-15-6-inch-dos-82c70016ih-iron-grey-1-85-kg-CMPLXLAPLENOVO-V15-AMY-S29032C064FA85-pdp?product_id=334228395&src=consumer_search-grid&svc=-1&tracker=%7C%7C%7C%7C%2Fg%2Felectronics%2Flaptop-computers%2Flaptops-glpid-6453%7C6453%7C21%7C%7C%7C%7C&get_review_id=331060535
"Dell Inspiron Core i3 10th Gen - (4 GB/1 TB HDD/Windows 10 Home) Inspiron 3501 Laptop  (15.6 inch, Softmint, 1.83 kg, With MS Office)",587,548,39,none,/dell-inspiron-core-i3-10th-gen-4-gb-1-tb-hdd-windows-10-home-inspiron-3501-laptop-15-6-inch-softmint-1-83-kg-with-ms-office-CMPLXLAPDELL-INSPIROBEST41443447464F6-pdp?product_id=333616794&src=consumer_search-grid&svc=-1&tracker=%7C%7C%7C%7C%2Fg%2Felectronics%2Flaptop-computers%2Flaptops-glpid-6453%7C6453%7C22%7C%7C%7C%7C&get_review_id=333157915
"HP Pavilion 14 (Intel Core i5- 10th Gen/8 GB RAM/ 1 TB HDD + 256 GB SSD/35.56 cm (14 inch)/Windows 10) CE3065TU (Mineral Silver ,1.7 kg)",952,890,62,none,/hp-pavilion-14-intel-core-i5-10th-gen-8-gb-1-tb-hdd-256-gb-ssd-35-56-cm-14-inch-windows-10-home-ms-office-14-ce3065tu-thin-and-light-laptop-mineral-silver-1-7-kg-CMPLXLAPHP-PAVILION-GADG48687B1661382-pdp?product_id=336904399&src=consumer_search-grid&svc=-1&tracker=%7C%7C%7C%7C%2Fg%2Felectronics%2Flaptop-computers%2Flaptops-glpid-6453%7C6453%7C23%7C%7C%7C%7C&get_review_id=332188113
"Lenovo V15-IIL Laptop (Core i3 10th Gen / 4 GB/15.6 inch/1 TB HDD/Windows 10 Home) 82C5A00AIH (Grey, 2.2 kg)",519,488,31,none,/lenovo-v15-iil-laptop-core-i3-10th-gen-4-gb-15-6-inch-1-tb-hdd-windows-10-home-82c5a00aih-grey-2-2-kg-CMPLXLAPLENOVO-V15-IGMCS31729993F74D3F-pdp?product_id=336633282&src=consumer_search-grid&svc=-1&tracker=%7C%7C%7C%7C%2Fg%2Felectronics%2Flaptop-computers%2Flaptops-glpid-6453%7C6453%7C24%7C%7C%7C%7C&get_review_id=333414838
Dell Inspiron 3493 14-inch HD Laptop (10th Gen Intel Core i3-1005G1/4GB/1TB HDD/Win 10 + MS Office/Intel HD Graphics/Silver) D560193WIN9SE,536,534,2,none,/dell-inspiron-3493-14-inch-hd-laptop-10th-gen-intel-core-i3-1005g1-4gb-1tb-hdd-win-10-+-ms-office-intel-hd-graphics-silver-d560193win9se-CMPLXLAPDELL-INSPIROLOWE54147639389ACD-pdp?product_id=332625217&src=consumer_search-grid&svc=-1&tracker=%7C%7C%7C%7C%2Fg%2Felectronics%2Flaptop-computers%2Flaptops-glpid-6453%7C6453%7C25%7C%7C%7C%7C&get_review_id=332407968
"HP 15s-GY0003AU Laptop (AMD Athlon Silver 3020e @1.2GHz/ 4GB Ram/ 1TB HDD/ 15.6"" HD/ Windows 10 Home / Jet Black / 1.8Kgs / No ODD) Without Optical Drive",479,404,75,none,/hp-15s-gy0003au-laptop-amd-athlon-silver-3020e-1-2ghz-4-gb-ram-1-tb-hdd-39-62-cm-15-6-inch-hd-1366-x-768-pixel-windows-10-home-without-optical-drive-jet-black-1-8-kg-CMPLXLAPHP-15S-GY000DUMM20256CC47C66D-pdp?product_id=336302742&src=consumer_search-grid&svc=-1&tracker=%7C%7C%7C%7C%2Fg%2Felectronics%2Flaptop-computers%2Flaptops-glpid-6453%7C6453%7C26%7C%7C%7C%7C&get_review_id=334441237
"Lenovo IdeaPad S340 Thin and Light Laptop (Intel Core i3-10th Gen/8 GB/1 TB HDD/Windows 10/14 inch Full HD IPS/MS Office 2019) 81VV00HEIN (Onyx Black, 1.6 kg)",849,630,219,none,/lenovo-ideapad-s340-thin-and-light-laptop-intel-core-i3-10th-gen-8-gb-1-tb-hdd-windows-10-14-inch-full-hd-ips-ms-office-2019-81vv00hein-onyx-black-1-6-kg-CMPLXLAPLENOVO-IDEAPDUMM2025695546C7F-pdp?product_id=337328509&src=consumer_search-grid&svc=-1&tracker=%7C%7C%7C%7C%2Fg%2Felectronics%2Flaptop-computers%2Flaptops-glpid-6453%7C6453%7C27%7C%7C%7C%7C&get_review_id=331819053
"HP 250 G7 (Intel Core i3-10th Gen/4 GB RAM/512 GB SSD/39.62 cm (15.6 inch)/Windows 10/With Fast Charging) 22A67PA (Dark Ash Silver, 1.78 kg)",630,603,27,none,/hp-250-g7-intel-core-i5-10th-gen-4-gb-ram-512-gb-ssd-39-62-cm-15-6-inch-windows-10-with-fast-charging-22a67pa-dark-ash-silver-1-78-kg-CMPLXLAPHP-250-G7-INLOWE541476F48765FE-pdp?product_id=332117686&src=consumer_search-grid&svc=-1&tracker=%7C%7C%7C%7C%2Fg%2Felectronics%2Flaptop-computers%2Flaptops-glpid-6453%7C6453%7C28%7C%7C%7C%7C&get_review_id=330911160
"HP 14 (Intel Core i5- 10th Gen /8 GB RAM /512 GB SSD /35.56 cm (14 inch) /Windows 10) 14-ck2018tu (Jet Black , 1.5 kg)",853,838,15,none,/hp-14-intel-core-i5-10th-gen-8-gb-ram-512-gb-ssd-35-56-cm-14-inch-windows-10-14-ck2018tu-jet-black-1-5-kg-CMPLXLAPHP-14-INTEL-GREE395087F5339C8E-pdp?product_id=336302128&src=consumer_search-grid&svc=-1&tracker=%7C%7C%7C%7C%2Fg%2Felectronics%2Flaptop-computers%2Flaptops-glpid-6453%7C6453%7C29%7C%7C%7C%7C&get_review_id=333243362
HP 245 G7 Laptop 2D8C6PA (AMD Ryzen 3-3300U/4GB Ram/ 1TB HDD/ 14.0 inch HD /Windows-10/AMD Radeon Vega 6 Graphics/ Dark Ash Silver/1.52Kg),478,444,34,none,/hp-245g7-2d8c6pa-laptop-amd-rhyzen-3-330u-2-1ghz-4gb-ram-1tb-hdd-14-hd-screen-windows-10-home-sl-integrated-standard-amd-radeon-vega-6-graphics-1-6kgs-no-odd-without-optical-drive-CMPLXLAPHP-245G7-2D8DUMM20256DD73CF3E-pdp?product_id=333218147&src=consumer_search-grid&svc=-1&tracker=%7C%7C%7C%7C%2Fg%2Felectronics%2Flaptop-computers%2Flaptops-glpid-6453%7C6453%7C30%7C%7C%7C%7C&get_review_id=333259017
HP 14s-er0002TU 14-inch FHD Laptop with Built-in 4G LTE (10th Gen Intel Core i3/ 4GB/1TB HDD/Windows 10/MS Office 2019/Natural Silver/1.51kg),719,616,103,none,/hp-14s-er0002tu-14-inch-fhd-laptop-with-built-in-4g-lte-10th-gen-intel-core-i3-4gb-1tb-hdd-windows-10-ms-office-2019-natural-silver-1-51kg-CMPLXLAPHP-14S-ER000DUMM20256F5EF16A1-pdp?product_id=333171199&src=consumer_search-grid&svc=-1&tracker=%7C%7C%7C%7C%2Fg%2Felectronics%2Flaptop-computers%2Flaptops-glpid-6453%7C6453%7C31%7C%7C%7C%7C&get_review_id=330702543
"HP 15s (Intel Core i5 10th Gen /8 GB DDR4/ 1 TB HDD/ 39.62 cm (15.6 inch)/ Windows 10) DU1079TX (Jet Black, 1.74 kg)",0,894,-894,none,/hp-15s-intel-core-i5-10th-gen-8-gb-ddr4-1-tb-hdd-39-62-cm-15-6-inch-windows-10-du1079tx-jet-black-1-74-kg-CMPLXLAPHP-15S-INTELGADG48687A2C4745B-pdp?product_id=333810344&src=consumer_search-grid&svc=-1&tracker=%7C%7C%7C%7C%2Fg%2Felectronics%2Flaptop-computers%2Flaptops-glpid-6453%7C6453%7C32%7C%7C%7C%7C&get_review_id=332929330
"Dell (Intel Core i5- 10th Gen/8 GB RAM/1 TB HDD + 256 GB SSD/39.62 cm (15.6 inch)/Windows 10) D560317HIN9BE (Black , 2.3 kg)",1120,1119,1,none,/dell-intel-core-i5-10th-gen-8-gb-ram-1-tb-hdd-+-256-gb-ssd-39-62-cm-15-6-inch-windows-10-d560317hin9be-black-2-3-kg-CMPLXLAPDELL-INTEL-CBEST41443AEA116D8-pdp?product_id=333070707&src=consumer_search-grid&svc=-1&tracker=%7C%7C%7C%7C%2Fg%2Felectronics%2Flaptop-computers%2Flaptops-glpid-6453%7C6453%7C1%7C%7C%7C%7C&get_review_id=332522316
"ASUS ROG Strix Scar 17 (Intel Core i7 / 10th Gen / 16 GB DDR4 1 TB SSD / 43.94 cm (17.3 inch)/ 8 GB NVIDIA GeForce RTX Windows 10) G732LXS-HG010T (Original Black, 2.99 kg)",4055,3108,947,none,/asus-rog-strix-scar-17-intel-core-i7-10th-gen-16-gb-ddr4-1-tb-ssd-43-94-cm-17-3-inch-8-gb-nvidia-geforce-rtx-windows-10-g732lxs-hg010t-original-black-2-99-kg-CMPLXLAPASUS-ROG-STRDUMM20256FF6EE2C7-pdp?product_id=332412139&src=consumer_search-grid&svc=-1&tracker=%7C%7C%7C%7C%2Fg%2Felectronics%2Flaptop-computers%2Flaptops-glpid-6453%7C6453%7C2%7C%7C%7C%7C&get_review_id=332412140
"HP 250 G7 Laptop (Intel Core i3-1005G1/10th Gen/4 GB RAM/1 TB HDD/39.62 cm (15.6 inch)/HD/Windows 10/Intel UHD Graphics/DVD WR) 1S5E9PA (Dark Ash Silver, 1.78 kg)",578,533,45,none,/hp-250-g7-laptop-intel-core-i3-1005g1-10th-gen-4-gb-ram-1-tb-hdd-39-62-cm-15-6-inch-hd-windows-10-intel-uhd-graphics-dvd-wr-1s5e9pa-dark-ash-silver-1-78-kg-CMPLXLAPHP-250-G7-LADUMM20256E5CA9813-pdp?product_id=332938927&src=consumer_search-grid&svc=-1&tracker=%7C%7C%7C%7C%2Fg%2Felectronics%2Flaptop-computers%2Flaptops-glpid-6453%7C6453%7C3%7C%7C%7C%7C&get_review_id=331393598
"Microsoft Surface Pro 7 M1866 31.24 cm (12.3 inch) Laptop (10th Gen Intel Core i5-1035G4/8GB/256GB SSD/Windows 10 Home/Intel Iris Plus Graphics), Black Without Keyboard",1699,1342,357,none,/microsoft-surface-pro-7-m1866-31-24-cm-12-3-inch-laptop-10th-gen-intel-core-i5-1035g4-8gb-256gb-ssd-windows-10-home-intel-iris-plus-graphics-black-without-keyboard-CMPLXLAPMICROSOFT-SUSUPE46222CAE26E5F-pdp?product_id=317295027&src=consumer_search-grid&svc=-1&tracker=%7C%7C%7C%7C%2Fg%2Felectronics%2Flaptop-computers%2Flaptops-glpid-6453%7C6453%7C4%7C%7C%7C%7C&get_review_id=317295029
"Acer Aspire 5 A514-54 (Intel Core i5-11th Gen/8 GB RAM/512 GB SSD/35.56 cm (14 inch)/FHD/Windows 10/2GB MX350 Graphics)Thin and Light Laptop (Pure Silver, 1.45 kg)",959,807,152,none,/acer-aspire-5-a514-54-intel-core-i5-11th-gen-8-gb-ram-512-gb-ssd-35-56-cm-14-inch-fhd-windows-10-2gb-mx350-graphics-thin-and-light-laptop-pure-silver-1-45-kg-CMPLXLAPACER-ASPIRE-BEST4144362A61BBF-pdp?product_id=334005536&src=consumer_search-grid&svc=-1&tracker=%7C%7C%7C%7C%2Fg%2Felectronics%2Flaptop-computers%2Flaptops-glpid-6453%7C6453%7C5%7C%7C%7C%7C&get_review_id=333880999
"Lenovo Ideapad 330S (Core i5 - 8th Gen / 4 GB RAM / 1 TB HDD / 39.62 cm (15.6 inch) FHD / Windows 10 / 2 GB Graphics) 81F500GLIN Thin and Light Laptop (Platinum Grey , 1.87 kg)",820,726,94,none,/lenovo-laptop-ip330s-81f500glin-ci5-8250u-4gb-1tb-39-6-cm-15-6-inch-fhd-ips-platinum-grey-radeon-540-2gbgfx-w10hsl-1yr-CMPLXLAPLENOVO-LAPTOLENO68659888F32CC3-pdp?product_id=223263517&src=consumer_search-grid&svc=-1&tracker=%7C%7C%7C%7C%2Fg%2Felectronics%2Flaptop-computers%2Flaptops-glpid-6453%7C6453%7C6%7C%7C%7C%7C&get_review_id=197907261
"Dell Inspiron 15 3593 15.6-inch FHD Laptop (10th Gen Core i3/4GB/1TB HDD/Windows 10 + MS Office/Intel HD Graphics)(Black, 2.03 Kg)",629,525,104,none,/dell-inspiron-15-3593-15-6-inch-fhd-laptop-10th-gen-core-i3-4gb-1tb-hdd-windows-10-+-ms-office-intel-hd-graphics-black-2-03-kg-CMPLXLAPDELL-INSPIROTECH1091875E5A5E56A-pdp?product_id=331008235&src=consumer_search-grid&svc=-1&tracker=%7C%7C%7C%7C%2Fg%2Felectronics%2Flaptop-computers%2Flaptops-glpid-6453%7C6453%7C7%7C%7C%7C%7C&get_review_id=330933631
"ASUS VivoBook Flip 14 Laptop (AMD Ryzen 3-4300U/4 GB RAM/256 GB SSD/35.56 cm (14 inch)/Windows 10 Home (64bit)/Integrated AMD Radeon RX Vega 5 Graphics) TM420IA-EC096TS (Bespoke Black, 1.6 kg)",822,709,113,none,/asus-vivobook-flip-14-laptop-amd-ryzen-3-4300u-4-gb-ram-256-gb-ssd-35-56-cm-14-inch-windows-10-home-64bit-integrated-amd-radeon-rx-vega-5-graphics-tm420ia-ec096ts-bespoke-black-1-6-kg-CMPLXLAPASUS-VIVOBOOASUS20915F9D39D20-pdp?product_id=332625280&src=consumer_search-grid&svc=-1&tracker=%7C%7C%7C%7C%2Fg%2Felectronics%2Flaptop-computers%2Flaptops-glpid-6453%7C6453%7C8%7C%7C%7C%7C&get_review_id=332449379
"Microsoft Surface Pro X (ARM 610/ 8 GB/ 128 GB SSD/ 33.02 cm (13 inch)/ Windows 10) 1876 (Matte Black , 0.77 kg)",1438,1233,205,none,/microsoft-surface-pro-x-arm-610-8-gb-128-gb-ssd-33-02-cm-13-inch-windows-10-1876-matte-black-0-77-kg-CMPLXLAPMICROSOFT-SUDUMM2025680AE6CED-pdp?product_id=330483994&src=consumer_search-grid&svc=-1&tracker=%7C%7C%7C%7C%2Fg%2Felectronics%2Flaptop-computers%2Flaptops-glpid-6453%7C6453%7C9%7C%7C%7C%7C&get_review_id=330483995
"HP 15s-DU1052TU Laptop (Intel Pentium Gold 6405U @2.4GHz/4 GB RAM/1 TB HDD/39.62 cm (15.6 inch)/FHD/Windows 10 Home/No ODD/Without Optical Drive) (Jet Black, 1.8 kg)",406,368,38,none,/hp-15s-du1052tu-laptop-intel-pentium-gold-6405u-2-4ghz-4-gb-ram-1-tb-hdd-39-62-cm-15-6-inch-fhd-windows-10-home-no-odd-without-optical-drive-jet-black-1-8-kg-CMPLXLAPHP-15S-DU105DUMM20256FC147254-pdp?product_id=335518649&src=consumer_search-grid&svc=-1&tracker=%7C%7C%7C%7C%2Fg%2Felectronics%2Flaptop-computers%2Flaptops-glpid-6453%7C6453%7C10%7C%7C%7C%7C&get_review_id=334754963
"Acer Predator Triton PT315-52 Gaming Laptop (Intel Core i5-10th Gen/8 GB RAM/512 GB SSD/39.62 cm (15.6 inch)/FHD/Windows 10 Home/4 GB GTX 1650Ti Graphics) NH.Q9YSI.002 (Abyssal Black, 2.5 kg)",1466,1329,137,none,/acer-predator-triton-pt315-52-gaming-laptop-intel-core-i5-10th-gen-8-gb-ram-512-gb-ssd-39-62-cm-15-6-inch-fhd-windows-10-home-4-gb-gtx-1650ti-graphics-nh-q9ysi-002-abyssal-black-2-5-kg-CMPLXLAPACER-PREDATOPIXE5840776B3AE39A-pdp?product_id=333906875&src=consumer_search-grid&svc=-1&tracker=%7C%7C%7C%7C%2Fg%2Felectronics%2Flaptop-computers%2Flaptops-glpid-6453%7C6453%7C11%7C%7C%7C%7C&get_review_id=333906880
Dell Inspiron 15 3593 15.6-inch FHD Laptop (10th Gen Core i3/4GB/1TB HDD/Windows 10 + MS Office/Intel HD Graphics/Silver),575,562,13,none,/dell-inspiron-15-3593-15-6-inch-fhd-laptop-10th-gen-core-i3-4gb-1tb-hdd-windows-10-+-ms-office-intel-hd-graphics-silver-CMPLXLAPDELL-INSPIROMY-S29032F7FA8A70-pdp?product_id=333065191&src=consumer_search-grid&svc=-1&tracker=%7C%7C%7C%7C%2Fg%2Felectronics%2Flaptop-computers%2Flaptops-glpid-6453%7C6453%7C12%7C%7C%7C%7C&get_review_id=330457812
"ASUS VivoBook 15 X509 ( Core i5- 8th Gen/8GB DDR4 /PCIEG NVME 512GB SSD/ 15.6"" FHD/ Windows 10/MX230 2GB GDDR5/FP/ Thin and light)  X509FJ-EJ502T (Slate Gray /1.9kg)",863,836,27,none,/asus-x509-core-i5-8th-gen-8gb-ddr4-pcieg-nvme-512gb-ssd-15-6-inch-fhd-windows-10-mx230-2gb-gddr5-fingerprint-sensor-x509fj-ej502t-slate-gray-1-9kg-CMPLXLAPASUS-X509-CODUMM20256C9FD8B5E-pdp?product_id=310783707&src=consumer_search-grid&svc=-1&tracker=%7C%7C%7C%7C%2Fg%2Felectronics%2Flaptop-computers%2Flaptops-glpid-6453%7C6453%7C13%7C%7C%7C%7C&get_review_id=280102913
"Acer Aspire 5 A514-54 Thin and Light Notebook (Intel Core i5-11th Gen/8 GB RAM/512 GB SSD/35.56 cm (14 inch)/FHD/Windows 10 Home/Intel Iris X Graphics) NX.A2ASI.001 (Safari Gold, 1.5 kg)",863,822,41,none,/acer-aspire-5-a514-54-thin-and-light-notebook-intel-core-i5-11th-gen-8-gb-ram-512-gb-ssd-35-56-cm-14-inch-fhd-windows-10-home-intel-iris-x-graphics-nx-a2asi-001-safari-gold-1-5-kg-CMPLXLAPACER-ASPIRE-PIXE58407766A64A74-pdp?product_id=334005540&src=consumer_search-grid&svc=-1&tracker=%7C%7C%7C%7C%2Fg%2Felectronics%2Flaptop-computers%2Flaptops-glpid-6453%7C6453%7C14%7C%7C%7C%7C&get_review_id=334005542
"Dell (Intel Core i7- 10th Gen/8 GB RAM/512 GB SSD/39.62 cm (15.6 inch)/Windows 10) I5501-7555SLV-PUS (Silver , 2 kg)",1315,1255,60,none,/dell-intel-core-i7-10th-gen-8-gb-ram-512-gb-ssd-39-62-cm-15-6-inch-windows-10-i5501-7555slv-pus-silver-2-kg-CMPLXLAPDELL-INTEL-CBEST4144311638620-pdp?product_id=333070708&src=consumer_search-grid&svc=-1&tracker=%7C%7C%7C%7C%2Fg%2Felectronics%2Flaptop-computers%2Flaptops-glpid-6453%7C6453%7C15%7C%7C%7C%7C&get_review_id=332522331
"ASUS VivoBook S14 (Intel Core i5-1135G7/8 GB RAM/512 GB NVMe SSD + 32 GB Optane Memory/35.56 cm (14 inch)/FHD/Windows 10/MS Office 2019/Integrated Graphics) S433EA-AM501TS (Indie Black, 1.40 kg)",1164,866,298,none,/asus-vivobook-s14-intel-core-i5-1135g7-8-gb-ram-512-gb-nvme-ssd-+-32-gb-optane-memory-35-56-cm-14-inch-fhd-windows-10-ms-office-2019-integrated-graphics-s433ea-am501ts-indie-black-1-40-kg-CMPLXLAPASUS-VIVOBOODUMM202568FD8271E-pdp?product_id=334230660&src=consumer_search-grid&svc=-1&tracker=%7C%7C%7C%7C%2Fg%2Felectronics%2Flaptop-computers%2Flaptops-glpid-6453%7C6453%7C16%7C%7C%7C%7C&get_review_id=333743211
"Acer Swift 3 SF314-510G Ultra Thin & Light Laptop (Intel Core i5-11th Gen/16 GB RAM/512 GB SSD/35.56 cm (14 inch)/FHD/Windows 10 Home/4 GB Intel Iris X Max Graphics) NX.A10SI.001 (Safari Gold, 1.1 kg)",1274,1123,151,none,/acer-swift-3-sf314-510g-ultra-thin-light-laptop-intel-core-i5-11th-gen-16-gb-ram-512-gb-ssd-35-56-cm-14-inch-fhd-windows-10-home-4-gb-intel-iris-x-max-graphics-nx-a10si-001-safari-gold-1-1-kg-CMPLXLAPACER-SWIFT-3PIXE584077F7C6BE1F-pdp?product_id=333906874&src=consumer_search-grid&svc=-1&tracker=%7C%7C%7C%7C%2Fg%2Felectronics%2Flaptop-computers%2Flaptops-glpid-6453%7C6453%7C17%7C%7C%7C%7C&get_review_id=333906881
"Dell (Intel Core i7- 10th Gen/8 GB RAM/512 GB SSD/39.62 cm (15.6 inch)/Windows 10) D560250WIN9BE (Eclipse Black , 2.3 kg)",1547,1260,287,none,/dell-intel-core-i7-10th-gen-8-gb-ram-512-gb-ssd-39-62-cm-15-6-inch-windows-10-d560250win9be-eclipse-black-2-3-kg-CMPLXLAPDELL-INTEL-CDUMM20256FB3FD399-pdp?product_id=333811860&src=consumer_search-grid&svc=-1&tracker=%7C%7C%7C%7C%2Fg%2Felectronics%2Flaptop-computers%2Flaptops-glpid-6453%7C6453%7C18%7C%7C%7C%7C&get_review_id=332522328
"Asus Vivobook (AMD Ryzen 5-3rd Gen/4 GB RAM/256 GB SSD/39.62 cm (15.6 Inch)/FHD/Windows 10/Integrated Graphics) M509DA-BQ1066T (Silver, 1.8 kg)",762,582,180,none,/asus-vivobook-amd-ryzen-5-3rd-gen-4-gb-ram-256-gb-ssd-39-62-cm-15-6-inch-fhd-windows-10-integrated-graphics-m509da-bq1066t-silver-1-8-kg-CMPLXLAPASUS-VIVOBOODUMM20256A856B2E4-pdp?product_id=337789770&src=consumer_search-grid&svc=-1&tracker=%7C%7C%7C%7C%2Fg%2Felectronics%2Flaptop-computers%2Flaptops-glpid-6453%7C6453%7C19%7C%7C%7C%7C&get_review_id=333870596
"ASUS ROG Strix Scar 15 (2020) (Intel Core i7 / 10th Gen / 16 GB DDR4 1 TB SSD / 39.62 cm (15.6 inch)/ 8 GB NVIDIA GeForce RTX Windows 10) G532LWS-HF127T (Original Black, 2.35 kg)",3014,2534,480,none,/asus-rog-strix-scar-15-2020-intel-core-i7-10th-gen-16-gb-ddr4-1-tb-ssd-39-62-cm-15-6-inch-8-gb-nvidia-geforce-rtx-windows-10-g532lws-hf127t-original-black-2-35-kg-CMPLXLAPASUS-ROG-STRASUS20915C4A02E7B-pdp?product_id=332412133&src=consumer_search-grid&svc=-1&tracker=%7C%7C%7C%7C%2Fg%2Felectronics%2Flaptop-computers%2Flaptops-glpid-6453%7C6453%7C20%7C%7C%7C%7C&get_review_id=332412137
DELL Inspiron 3593 15.6-inch Laptop (10th Gen Core i5-1035G1/4GB/1TB + 256GB SSD/Window 10 + Microsoft Office/Integrated Graphics)  Platinum Silver-,808,766,42,none,/dell-inspiron-3593-15-6-inch-laptop-10th-gen-core-i5-1035g1-4gb-1tb-+-256gb-ssd-window-10-+-microsoft-office-integrated-graphics-platinum-silver-CMPLXLAPDELL-INSPIRODUMM20256E284B2A6-pdp?product_id=334261276&src=consumer_search-grid&svc=-1&tracker=%7C%7C%7C%7C%2Fg%2Felectronics%2Flaptop-computers%2Flaptops-glpid-6453%7C6453%7C21%7C%7C%7C%7C&get_review_id=330457818
ASUS ZenBook Pro Duo Intel Core i7-10750H 10th Gen 15.6 4K UHD OLED Touchscreen Laptop (32GB RAM/1TB NVMe SSD/Windows 10/6GB NVIDIA GeForce RTX 2060 Graphics/Celestial Blue/2.5 Kg)  UX581LV-H2034T,3738,3164,574,none,/asus-zenbook-pro-duo-intel-core-i7-10750h-10th-gen-15-6-4k-uhd-oled-touchscreen-laptop-32gb-ram-1tb-nvme-ssd-windows-10-6gb-nvidia-geforce-rtx-2060-graphics-celestial-blue-2-5-kg-ux581lv-h2034t-CMPLXLAPASUS-ZENBOOKASUS2091516B6D114-pdp?product_id=333858319&src=consumer_search-grid&svc=-1&tracker=%7C%7C%7C%7C%2Fg%2Felectronics%2Flaptop-computers%2Flaptops-glpid-6453%7C6453%7C22%7C%7C%7C%7C&get_review_id=333858322
"Dell Inspiron 15 3593 (Core i5-10th Gen/4 GB RAM/512 GB SSD/39.62 cm (15.6 inch)/FHD/Windows 10/ MS Office) Thin and Light Laptop (Platinum Silver, 2.2 kg)",877,781,96,none,/dell-inspiron-15-3593-core-i5-10th-gen-4-gb-ram-512-gb-ssd-39-62-cm-15-6-inch-fhd-windows-10with-ms-office-home-student-2016-platinum-silver-2-2-kg-CMPLXLAPDELL-INSPIROSSD43070186F83CA-pdp?product_id=333898022&src=consumer_search-grid&svc=-1&tracker=%7C%7C%7C%7C%2Fg%2Felectronics%2Flaptop-computers%2Flaptops-glpid-6453%7C6453%7C23%7C%7C%7C%7C&get_review_id=302438888
"Dell (Intel Core i5- 10th Gen/8 GB RAM/512 GB SSD/39.62 cm (15.6 inch)/Windows 10) BBY-78KFDFX (Black , 2.61 kg)",1286,1233,53,none,/dell-intel-core-i5-10th-gen-8-gb-ram-512-gb-ssd-39-62-cm-15-6-inch-windows-10-bby-78kfdfx-black-2-61-kg-CMPLXLAPDELL-INTEL-CDUMM20256D2BEE4B-pdp?product_id=333070706&src=consumer_search-grid&svc=-1&tracker=%7C%7C%7C%7C%2Fg%2Felectronics%2Flaptop-computers%2Flaptops-glpid-6453%7C6453%7C24%7C%7C%7C%7C&get_review_id=332522313
"Asus ZenBook Flip 14 (Intel Core i3-10th Gen 4 GB RAM 512 GB SSD/35.6 cm (14 inch)/Windows 10) TP412FA-EC371TS (Grey, 2.04 kg)",815,683,132,none,/asus-zenbook-flip-14-intel-core-i3-10th-gen-4-gb-ram-512-gb-ssd-35-6-cm-14-inch-windows-10-tp412fa-ec371ts-grey-2-04-kg-CMPLXLAPASUS-ZENBOOKDUMM20256BE5D4E47-pdp?product_id=329303670&src=consumer_search-grid&svc=-1&tracker=%7C%7C%7C%7C%2Fg%2Felectronics%2Flaptop-computers%2Flaptops-glpid-6453%7C6453%7C25%7C%7C%7C%7C&get_review_id=329303671
"Asus VivoBook Flip 14 AMD Ryzen 7 4th Gen 8 GB DDR4 512 GB SSD 35.56 cm (14 inch) Windows 10 TM420IA-EC098TS (Bespoke Black, 1.5 kg)",1164,1027,137,none,/asus-vivobook-flip-14-amd-ryzen-7-4th-gen-8-gb-ddr4-512-gb-ssd-35-56-cm-14-inch-windows-10-tm420ia-ec098ts-bespoke-black-1-5-kg-CMPLXLAPASUS-VIVOBOODUMM20256DAD3642D-pdp?product_id=332625277&src=consumer_search-grid&svc=-1&tracker=%7C%7C%7C%7C%2Fg%2Felectronics%2Flaptop-computers%2Flaptops-glpid-6453%7C6453%7C26%7C%7C%7C%7C&get_review_id=331785452
"Dell Inspiron 3501 (Intel Core i3- 10th Gen / 4 GB RAM / 1TB HDD / 39.62 cm (15.6 inch) / Windows 10 )D560354WIN9B (Accent Black,2.24 kg)",615,553,62,none,/dell-inspiron-3501-intel-core-i3-10th-gen-4-gb-ram-1tb-hdd-39-62-cm-15-6-inch-windows-10-d560354win9b-accent-black-2-24-kg-CMPLXLAPDELL-INSPIRODUMM20256EA06644-pdp?product_id=333616796&src=consumer_search-grid&svc=-1&tracker=%7C%7C%7C%7C%2Fg%2Felectronics%2Flaptop-computers%2Flaptops-glpid-6453%7C6453%7C27%7C%7C%7C%7C&get_review_id=333189599
ASUS VivoBook S S14 Intel Core i7-1165G7 11th Gen  14-inch FHD Thin and Light Laptop (8GB RAM/512GB SSD + 32GB Optane Memory/Windows 10/Office 2019/Iris X Graphics/Indie Black/1.4 Kg)  S433EA-AM701TS,1575,1055,520,none,/asus-vivobook-s-s14-intel-core-i7-1165g7-11th-gen-14-inch-fhd-thin-and-light-laptop-8gb-ram-512gb-ssd-+-32gb-optane-memory-windows-10-office-2019-iris-x-graphics-indie-black-1-4-kg-s433ea-am701ts-CMPLXLAPASUS-VIVOBOOASUS209158A367CBA-pdp?product_id=333858311&src=consumer_search-grid&svc=-1&tracker=%7C%7C%7C%7C%2Fg%2Felectronics%2Flaptop-computers%2Flaptops-glpid-6453%7C6453%7C28%7C%7C%7C%7C&get_review_id=333858313
"Dell Latitude 3400 8th Gen Intel Core i3- 8145U (8 GB DDR4 RAM, 256 GB SSD, 35.56 cm (14 inch) HD (1366 x 768)  Anti-Glare, Windows 10 Pro, AI3400 (Black, 1.61 kg))",850,758,92,none,/dell-latitude-3400-8th-gen-intel-core-i3-8145u-8-gb-ddr4-ram-256-gb-ssd-35-56-cm-14-inch-hd-1366-x-768-anti-glare-windows-10-pro-ai3400-black-1-61-kg-CMPLXLAPDELL-LATITUDDUMM20256AB62322A-pdp?product_id=333811863&src=consumer_search-grid&svc=-1&tracker=%7C%7C%7C%7C%2Fg%2Felectronics%2Flaptop-computers%2Flaptops-glpid-6453%7C6453%7C29%7C%7C%7C%7C&get_review_id=332494903
Asus ROG Strix G15 G512LU-HN181T i7-10750H/ GTX1660Ti (6GB)/ 16GB/ 512GB SSD/ 15.6 FHD-144hz/ 66Wh/ Black PLASTIC/ WIN10/ 1YR/ 2.3kg,2123,1384,739,none,/asus-rog-strix-g15-g512lu-hn181t-i7-10750h-gtx1660ti-6gb-16gb-512gb-ssd-15-6-fhd-144hz-66wh-black-plastic-win10-1yr-2-3kg-CMPLXLAPASUS-ROG-STRASUS2091519551ABA-pdp?product_id=332493776&src=consumer_search-grid&svc=-1&tracker=%7C%7C%7C%7C%2Fg%2Felectronics%2Flaptop-computers%2Flaptops-glpid-6453%7C6453%7C30%7C%7C%7C%7C&get_review_id=332493780
"Dell Latitude 3400 8th Gen Intel Core i3- 8145U (4 GB DDR4 RAM, 1TB HDD, 35.56 cm (14 inch) HD (1366 x 768)  Anti-Glare, Windows 10 Pro, N001I3400006IN9 (Black, 1.61 kg))",793,707,86,none,/dell-latitude-3400-8th-gen-intel-core-i3-8145u-4-gb-ddr4-ram-1tb-hdd-35-56-cm-14-inch-hd-1366-x-768-anti-glare-windows-10-pro-n001i3400006in9-black-1-61-kg-CMPLXLAPDELL-LATITUDHOME8444063614B8B2-pdp?product_id=333811866&src=consumer_search-grid&svc=-1&tracker=%7C%7C%7C%7C%2Fg%2Felectronics%2Flaptop-computers%2Flaptops-glpid-6453%7C6453%7C31%7C%7C%7C%7C&get_review_id=332494896
"ASUS ZenBook 14 (2020) (Intel Core i5-11th Gen/8 GB RAM/512 GB SSD/35.56 cm (14 Inch)/FHD/Windows 10/Intel Iris X Graphics) UX425EA-BM501TS (Pine Grey, 1.13 kg)",1363,1048,315,none,/asus-zenbook-14-2020-intel-core-i5-11th-gen-8-gb-ram-512-gb-ssd-35-56-cm-14-inch-fhd-windows-10-intel-iris-x-graphics-ux425ea-bm501ts-pine-grey-1-13-kg-CMPLXLAPASUS-ZENBOOKREAL40006B8CDEA55-pdp?product_id=336891515&src=consumer_search-grid&svc=-1&tracker=%7C%7C%7C%7C%2Fg%2Felectronics%2Flaptop-computers%2Flaptops-glpid-6453%7C6453%7C32%7C%7C%7C%7C&get_review_id=333870577
"Acer Aspire 5 A514-53G Thin and Light Laptop (Intel Core i5-10th Gen/8 GB RAM/512 GB SSD/35.56 cm (14 inch)/FHD/Windows 10 Home/NVIDIA GeForce MX350 Graphics) NX.HYZSI.001 (Silver, 1.5 kg)",931,849,82,none,/acer-aspire-5-a514-53g-thin-and-light-laptop-intel-core-i5-10th-gen-8-gb-ram-512-gb-ssd-35-56-cm-14-inch-fhd-windows-10-home-nvidia-geforce-mx350-graphics-nx-hyzsi-001-silver-1-5-kg-CMPLXLAPACER-ASPIRE-PIXE58407752334E89-pdp?product_id=334005537&src=consumer_search-grid&svc=-1&tracker=%7C%7C%7C%7C%2Fg%2Felectronics%2Flaptop-computers%2Flaptops-glpid-6453%7C6453%7C1%7C%7C%7C%7C&get_review_id=334005539
"Dell latitude 3400 ( Intel Core i7-8th Gen/8 GB RAM/1 TB/35.56 cm (14 inch)/HD/Windows 10/2GB NVIDIA GeForce MX130 Graphics) Thin and Light (Black, 2.04 kg)",1368,1122,246,none,/dell-latitude-3400-intel-core-i7-8th-gen-8-gb-ram-1-tb-35-56-cm-14-inch-hd-windows-10-2gb-nvidia-geforce-mx130-graphics-thin-and-light-black-2-04-kg-CMPLXLAPDELL-LATITUDPRIN853275E72BFE21-pdp?product_id=333811865&src=consumer_search-grid&svc=-1&tracker=%7C%7C%7C%7C%2Fg%2Felectronics%2Flaptop-computers%2Flaptops-glpid-6453%7C6453%7C2%7C%7C%7C%7C&get_review_id=331787993
"Asus ROG Strix G15 (Intel Core i5-10300H/8 GB RAM/1 TB SSD/39.62 cm (15.6 inch)/FHD/Windows 10/NVIDIA Geforce GTX 1650 Ti 4GB Graphics) G512LI-HN091T (Glacier Blue, 2.5 kg)",1438,1096,342,none,/asus-rog-strix-g15-intel-core-i5-10300h-8-gb-ram-1-tb-ssd-39-62-cm-15-6-inch-fhd-windows-10-nvidia-geforce-gtx-1650-ti-4gb-graphics-g512li-hn091t-glacier-blue-2-5-kg-CMPLXLAPASUS-ROG-STRDUMM20256D162459F-pdp?product_id=332439541&src=consumer_search-grid&svc=-1&tracker=%7C%7C%7C%7C%2Fg%2Felectronics%2Flaptop-computers%2Flaptops-glpid-6453%7C6453%7C3%7C%7C%7C%7C&get_review_id=332439542
"HP 250 G7 (Core i3 7th Gen / 4GB RAM / 1TB HDD /15.6""/Win 10/Grey) 7HA07PA",588,551,37,none,/hp-250-g7-core-i3-7th-gen-4-gb-1-tb-39-62-cm-16-5-inch-windows-10-grey-1-79-kg-CMPLXLAPHP-250-G7-COK-G-7246354437F020-pdp?product_id=273984507&src=consumer_search-grid&svc=-1&tracker=%7C%7C%7C%7C%2Fg%2Felectronics%2Flaptop-computers%2Flaptops-glpid-6453%7C6453%7C4%7C%7C%7C%7C&get_review_id=273984509
"Apple MacBook Air M1 - (8 GB/512 GB SSD/Mac OS Big Sur) MGN73HN/A  (13.3 inch, Space Grey, 1.29 kg)",0,1615,-1615,none,/apple-macbook-air-m1-8-gb-512-gb-ssd-mac-os-big-sur-mgn73hn-a-13-3-inch-space-grey-1-29-kg-CMPLXLAPAPPLE-MACBOODUMM202567A4C53D7-pdp?product_id=337139264&src=consumer_search-grid&svc=-1&tracker=%7C%7C%7C%7C%2Fg%2Felectronics%2Flaptop-computers%2Flaptops-glpid-6453%7C6453%7C5%7C%7C%7C%7C&get_review_id=334874202
Lenovo IdeaPad Slim 3 (AMD Ryzen 3/4 GB RAM/1 TB HDD/ 39.62 cm (15.6 inch)/FHD/Windows 10/MS Office/Thin and Light Laptop) 81W10052IN (Platinum Grey  1.85 kg),507,404,103,none,/lenovo-ideapad-slim-3-amd-ryzen-3-4-gb-ram-1-tb-hdd-39-62-cm-15-6-inch-fhd-windows-10-ms-office-thin-and-light-laptop-81w10052in-platinum-grey-1-85-kg-CMPLXLAPLENOVO-IDEAPDUMM2025682B6EBE6-pdp?product_id=331053598&src=consumer_search-grid&svc=-1&tracker=%7C%7C%7C%7C%2Fg%2Felectronics%2Flaptop-computers%2Flaptops-glpid-6453%7C6453%7C6%7C%7C%7C%7C&get_review_id=331053599
"Dell Inspiron 5408 14 inch FHD Laptop (10th Gen Intel Core i5-1035G1/8 GB/512 SSD/2 GB NVIDIA Graphics/Win 10 + MS Office) D560210WIN9SE (1.4 kg, Pebble)",1130,996,134,none,/dell-inspiron-5408-14-inch-fhd-laptop-10th-gen-intel-core-i5-1035g1-8-gb-512-ssd-2-gb-nvidia-graphics-win-10-+-ms-office-d560210win9se-1-4-kg-pebble-CMPLXLAPDELL-INSPIRODUMM20256623ED87E-pdp?product_id=332890566&src=consumer_search-grid&svc=-1&tracker=%7C%7C%7C%7C%2Fg%2Felectronics%2Flaptop-computers%2Flaptops-glpid-6453%7C6453%7C7%7C%7C%7C%7C&get_review_id=332644937
Acer Swift 3 SF314-57G 14-inch Laptop (10th Gen Intel Core i5-1035G1 processor/8GB LPDDR4/512 SSD/Windows 10/2GB NVIDIA GeForce MX250 Graphics/Thunderbolt 3) (Steel Grey 1.18 kg),1233,986,247,none,/acer-swift-3-sf314-57g-14-inch-laptop-10th-gen-intel-core-i5-1035g1-processor-8gb-lpddr4-512-ssd-windows-10-2gb-nvidia-geforce-mx250-graphics-thunderbolt-3-steel-grey-1-18-kg-CMPLXLAPACER-SWIFT-3DUMM20256CFAA6664-pdp?product_id=331919044&src=consumer_search-grid&svc=-1&tracker=%7C%7C%7C%7C%2Fg%2Felectronics%2Flaptop-computers%2Flaptops-glpid-6453%7C6453%7C8%7C%7C%7C%7C&get_review_id=310779600
"Asus ZenBook Flip 14 (Intel Core i3-10th Gen 4 GB RAM 512 GB SSD/35.6 cm (14 inch)/Windows 10) TP412FA-EC372TS (Silver Blue, 2.04 kg)",815,655,160,none,/asus-zenbook-flip-14-intel-core-i3-10th-gen-4-gb-ram-512-gb-ssd-35-6-cm-14-inch-windows-10-tp412fa-ec372ts-silver-blue-2-04-kg-CMPLXLAPASUS-ZENBOOKASUS20915EAFBE05D-pdp?product_id=329303672&src=consumer_search-grid&svc=-1&tracker=%7C%7C%7C%7C%2Fg%2Felectronics%2Flaptop-computers%2Flaptops-glpid-6453%7C6453%7C9%7C%7C%7C%7C&get_review_id=329303674
"HP 14-DK0093AU (Ryzen 5/ 8GB/ 1TB HDD + 256GB SSD/ 14-inch FHD/ Windows 10 Home/ Integrated Graphics) Thin and Light Laptop (Natural Silver, 1.7kg)",815,664,151,none,/hp-14-14-dk0093au-2019-14-inch-laptop-ryzen-5-3500u-8gb-1tb-hdd-+-256gb-ssd-windows-10-home-radeon-vega-8-graphics-natural-silver-1-7-kg-CMPLXLAPHP-14-14-DK0MOBI229438F447EA5-pdp?product_id=332977173&src=consumer_search-grid&svc=-1&tracker=%7C%7C%7C%7C%2Fg%2Felectronics%2Flaptop-computers%2Flaptops-glpid-6453%7C6453%7C10%7C%7C%7C%7C&get_review_id=312866549
"Lenovo Ideapad Slim 3 (Intel Core i3- 10th Gen /4GB Ram/1TB HDD/35.56 cm (14 inch) /Windows 10) 81WD00JYIN (Platinum Grey,1.6Kg)",671,507,164,none,/lenovo-ideapad-slim-3-intel-core-i3-10th-gen-4gb-ram-1tb-hdd-35-56-cm-14-inch-windows-10-81wd00jyin-platinum-grey-1-6kg-CMPLXLAPLENOVO-IDEAPLOWE541476BB1080F2-pdp?product_id=337328517&src=consumer_search-grid&svc=-1&tracker=%7C%7C%7C%7C%2Fg%2Felectronics%2Flaptop-computers%2Flaptops-glpid-6453%7C6453%7C11%7C%7C%7C%7C&get_review_id=330610365
"Dell Latitude 3400 8th Gen Intel Core i5- 8265U (4 GB DDR4 RAM, 1TB HDD, 35.56 cm (14 inch) HD (1366 x 768)  Anti-Glare, Windows 10 Pro, N001I3400B013IN9 (Black, 1.61 kg))",1032,968,64,none,/dell-latitude-3400-8th-gen-intel-core-i5-8265u-4-gb-ddr4-ram-1tb-hdd-35-56-cm-14-inch-hd-1366-x-768-anti-glare-windows-10-pro-n001i3400b013in9-black-1-61-kg-CMPLXLAPDELL-LATITUDHOME8444061DCE4AFA-pdp?product_id=333811867&src=consumer_search-grid&svc=-1&tracker=%7C%7C%7C%7C%2Fg%2Felectronics%2Flaptop-computers%2Flaptops-glpid-6453%7C6453%7C12%7C%7C%7C%7C&get_review_id=332494900
"Acer Swift 3 SF314-57G-53SU (Intel Core i5-10th Gen/8 GB RAM/512 GB SSD/35.56 cm (14 inch)FHD/Windows 10/NVIDIA GeForce MX250 2GB Graphics) NX.HJESI.003 (Steel Grey, 1.7 kg)",1233,904,329,none,/acer-swift-3-sf314-57g-53su-intel-core-i5-10th-gen-8-gb-ram-512-gb-ssd-35-56-cm-14-inch-fhd-windows-10-nvidia-geforce-mx250-2gb-graphics-nx-hjesi-003-steel-grey-1-7-kg-CMPLXLAPACER-SWIFT-3DUMM20256367D150C-pdp?product_id=333906493&src=consumer_search-grid&svc=-1&tracker=%7C%7C%7C%7C%2Fg%2Felectronics%2Flaptop-computers%2Flaptops-glpid-6453%7C6453%7C13%7C%7C%7C%7C&get_review_id=332123668
"HP 15 Thin & Light 15.6-inch FHD Laptop (11th Gen Intel Core i5-1135G7, 8GB DDR4, 256GB SSD + 1TB HDD, Win 10 Home, MS Office, 2GB MX350 Graphics, FPR, Natural Silver, 1.76 Kg), 15s-du3047TX",1042,856,186,none,/hp-15-thin-light-15-6-inch-fhd-laptop-11th-gen-intel-core-i5-1135g7-8gb-ddr4-256gb-ssd-+-1tb-hdd-win-10-home-ms-office-2gb-mx350-graphics-fpr-natural-silver-1-76-kg-15s-du3047tx-CMPLXLAPHP-15-THIN-LDUMM202566E1CF509-pdp?product_id=337799856&src=consumer_search-grid&svc=-1&tracker=%7C%7C%7C%7C%2Fg%2Felectronics%2Flaptop-computers%2Flaptops-glpid-6453%7C6453%7C14%7C%7C%7C%7C&get_review_id=333927962
"Lenovo Ideapad Slim 3 (AMD Athlon Silver 3050U/4 GB RAM/1 TB HDD/ 39.62 (15.6 inch)/Windows 10/MS-Office/Integrated AMD Radeon Graphics) 81W100HKIN (Platinum Grey, 1.85 kg)",449,411,38,none,/lenovo-ideapad-slim-3-amd-athlon-silver-3050u-4-gb-ram-1-tb-hdd-39-62-15-6-inch-windows-10-ms-office-integrated-amd-radeon-graphics-81w100hkin-platinum-grey-1-85-kg-CMPLXLAPLENOVO-IDEAPDUMM20256A008413-pdp?product_id=337898675&src=consumer_search-grid&svc=-1&tracker=%7C%7C%7C%7C%2Fg%2Felectronics%2Flaptop-computers%2Flaptops-glpid-6453%7C6453%7C15%7C%7C%7C%7C&get_review_id=331053469
"ASUS VivoBook (AMD Ryzen 3-3rd Gen/4 GB RAM/256 GB SSD/39.62 cm (15.6 Inch)/FHD/Windows 10/Integrated Vega 3 Graphics) M515DA-EJ312TS (Transparent Silver, 1.8 kg)",541,463,78,none,/asus-vivobook-amd-ryzen-3-3rd-gen-4-gb-ram-256-gb-ssd-39-62-cm-15-6-inch-fhd-windows-10-integrated-vega-3-graphics-m515da-ej312ts-transparent-silver-1-8-kg-CMPLXLAPASUS-VIVOBOODUMM20256D50108F1-pdp?product_id=333895312&src=consumer_search-grid&svc=-1&tracker=%7C%7C%7C%7C%2Fg%2Felectronics%2Flaptop-computers%2Flaptops-glpid-6453%7C6453%7C16%7C%7C%7C%7C&get_review_id=333870588
"Dell latitude 3400 ( Intel Core i5-8th Gen/8 GB RAM/1 TB/35.56 cm (14 inch)/HD/Windows 10) Thin and Light (Black, 2.04 kg)",1040,944,96,none,/dell-latitude-3400-intel-core-i5-8th-gen-8-gb-ram-1-tb-35-56-cm-14-inch-hd-windows-10-thin-and-light-black-2-04-kg-CMPLXLAPDELL-LATITUDDUMM20256D6E3A788-pdp?product_id=333811864&src=consumer_search-grid&svc=-1&tracker=%7C%7C%7C%7C%2Fg%2Felectronics%2Flaptop-computers%2Flaptops-glpid-6453%7C6453%7C17%7C%7C%7C%7C&get_review_id=331787997
"Acer Swift 3 SF313-53 Ultra Thin and Light Notebook (Intel Core i5-11th Gen/8 GB RAM/512 GB SSD/33.02 cm (13 inch)/FHD/Windows 10 Home/Integrated Graphics) NX.A4KSI.001 (Pure Silver, 2.3 kg)",1110,1000,110,none,/acer-swift-3-sf313-53-ultra-thin-and-light-notebook-intel-core-i5-11th-gen-8-gb-ram-512-gb-ssd-33-02-cm-13-inch-fhd-windows-10-home-integrated-graphics-nx-a4ksi-001-pure-silver-2-3-kg-CMPLXLAPACER-SWIFT-3DUMM20256C79AF240-pdp?product_id=333906871&src=consumer_search-grid&svc=-1&tracker=%7C%7C%7C%7C%2Fg%2Felectronics%2Flaptop-computers%2Flaptops-glpid-6453%7C6453%7C18%7C%7C%7C%7C&get_review_id=333906872
"HP 250-G7 (Core i5-8th Gen/15.6 inch/ 8GB/ 1TB HDD/ Windows 10/ DVD Writer) 6YN32PA (Black, 1.79 kg)",822,788,34,none,/hp-250-g7-laptop-core-i5-8th-gen-8gb-1tb-windows-10-6yn32pa-black-1-79-kg-CMPLXLAPHP-250-G7-LADUMM20256591DF324-pdp?product_id=249534436&src=consumer_search-grid&svc=-1&tracker=%7C%7C%7C%7C%2Fg%2Felectronics%2Flaptop-computers%2Flaptops-glpid-6453%7C6453%7C19%7C%7C%7C%7C&get_review_id=249534437
Lenovo 82C700D4IH V15 ADA  (AMD Athlon Silver 3050U/4GB Ram/ 1TB HDD/ 15.6 HD AG/ DOS/Integrated AMD Radeon Graphics/ Iron Grey/1.85KG),411,349,62,none,/lenovo-82c700d4ih-v15-ada-amd-athlon-silver-3050u-4gb-ram-1tb-hdd-15-6-hd-ag-dos-integrated-amd-radeon-graphics-iron-grey-1-85kg-CMPLXLAPLENOVO-82C70DUMM2025655F8D3B8-pdp?product_id=334818708&src=consumer_search-grid&svc=-1&tracker=%7C%7C%7C%7C%2Fg%2Felectronics%2Flaptop-computers%2Flaptops-glpid-6453%7C6453%7C20%7C%7C%7C%7C&get_review_id=330679465
"ASUS ROG Strix G17 G712LU-EV013T (10th Gen  Intel Core i7-10750H, 16GB RAM, 512GB SSD, RGB Backlit 4-Zone, 144 Hz Gaming GTX 1660Ti 6GB, Windows 10, WiFi 6, Black - 17.3 Inch Full HD)",1849,1440,409,none,/asus-rog-strix-g17-g712lu-ev013t-10th-gen-intel-core-i7-10750h-16gb-ram-512gb-ssd-rgb-backlit-4-zone-144-hz-gaming-gtx-1660ti-6gb-windows-10-wifi-6-black-17-3-inch-full-hd-CMPLXLAPASUS-ROG-STRDUMM2025653F5EBA-pdp?product_id=336537653&src=consumer_search-grid&svc=-1&tracker=%7C%7C%7C%7C%2Fg%2Felectronics%2Flaptop-computers%2Flaptops-glpid-6453%7C6453%7C21%7C%7C%7C%7C&get_review_id=332556645
"HP 14s cf3006tu 14-inch FHD Laptop (10th Gen intel Core i3/4GB/1TB HDD/Windows 10 + MS Office 2019/Intel UHD Graphics), Natural Silver",682,555,127,none,/hp-14s-cf3006tu-14-inch-fhd-laptop-10th-gen-intel-core-i3-4gb-1tb-hdd-windows-10-+-ms-office-2019-intel-uhd-graphics-natural-silver-CMPLXLAPHP-14S-CF300MY-S2903217EFA633-pdp?product_id=337451592&src=consumer_search-grid&svc=-1&tracker=%7C%7C%7C%7C%2Fg%2Felectronics%2Flaptop-computers%2Flaptops-glpid-6453%7C6453%7C22%7C%7C%7C%7C&get_review_id=330702541
Acer Aspire 3 A315-56-323J 15.6-inch Laptop (Intel Core i3-1005G1/4GB/1TB HDD/Window 10  Home  64Bit/Intel UHD Graphics)  NX.HS5SI.006 Black,630,466,164,none,/acer-aspire-3-a315-56-15-6-inch-laptop-intel-core-i3-1005g1-4gb-1tb-hdd-window-10-home-64bit-intel-uhd-graphics-nx-hs5si-006-black-CMPLXLAPACER-ASPIRE-ECLI104892316527FB-pdp?product_id=331919030&src=consumer_search-grid&svc=-1&tracker=%7C%7C%7C%7C%2Fg%2Felectronics%2Flaptop-computers%2Flaptops-glpid-6453%7C6453%7C23%7C%7C%7C%7C&get_review_id=331027965
"Lenovo ThinkBook 14 Core i3 10th Gen - (4 GB/1 TB HDD/Windows 10) ThinkBook 14 IIL Thin and Light Laptop  (14 inch, Mineral Grey, 1.5 kg)",674,493,181,none,/lenovo-thinkbook-14-core-i3-10th-gen-4-gb-1-tb-hdd-windows-10-thinkbook-14-iil-thin-and-light-laptop-14-inch-mineral-grey-1-5-kg-CMPLXLAPLENOVO-THINKESEL58411262DA81D0-pdp?product_id=336943450&src=consumer_search-grid&svc=-1&tracker=%7C%7C%7C%7C%2Fg%2Felectronics%2Flaptop-computers%2Flaptops-glpid-6453%7C6453%7C24%7C%7C%7C%7C&get_review_id=333237355
"ASUS ROG Strix G15 (Intel Core i5 -10th Gen / 8 GB RAM/ 1TB SSD / 39.62 cm (15.6 inch) / Windows 10)G512LI-HN118T (Electro Punk, 2.7 kg )",1849,1112,737,none,/asus-rog-strix-g15-intel-core-i5-10th-gen-8-gb-ram-1tb-ssd-39-62-cm-15-6-inch-windows-10-g512li-hn118t-electro-punk-2-7-kg-CMPLXLAPASUS-ROG-STRASUS20915405B1332-pdp?product_id=331848264&src=consumer_search-grid&svc=-1&tracker=%7C%7C%7C%7C%2Fg%2Felectronics%2Flaptop-computers%2Flaptops-glpid-6453%7C6453%7C25%7C%7C%7C%7C&get_review_id=331848266
"Lenovo Ideapad Slim 3 (10th Gen Intel Core i5-1035G1/8GB Ram/1TB HDD/15.6 inch FHD/Windows 10/MS-Office/Grey/ 1.85Kg), 81WE004WIN  Thin and Light Laptop",916,616,300,none,/lenovo-ideapad-slim-3-10th-gen-intel-core-i5-1035g1-8gb-ram-1tb-hdd-15-6-inch-fhd-windows-10-ms-office-grey-1-85kg-81we004win-thin-and-light-laptop-CMPLXLAPLENOVO-IDEAPDUMM202565E4E474B-pdp?product_id=336376164&src=consumer_search-grid&svc=-1&tracker=%7C%7C%7C%7C%2Fg%2Felectronics%2Flaptop-computers%2Flaptops-glpid-6453%7C6453%7C26%7C%7C%7C%7C&get_review_id=331839961
Acer Aspire 3 A315-56-51UL 15.6-inch Laptop (Intel Core i5-1035G1/8GB/1TB HDD/Window 10  Home  64Bit/Intel UHD Graphics)  NX.HS5SI.003 Black,729,685,44,none,/acer-aspire-3-a315-56-15-6-inch-laptop-intel-core-i5-1035g1-8gb-1tb-hdd-window-10-home-64bit-intel-uhd-graphics-nx-hs5si-003-black-CMPLXLAPACER-ASPIRE-ECLI10489212BBA9D1-pdp?product_id=331918836&src=consumer_search-grid&svc=-1&tracker=%7C%7C%7C%7C%2Fg%2Felectronics%2Flaptop-computers%2Flaptops-glpid-6453%7C6453%7C27%7C%7C%7C%7C&get_review_id=331027962
HP Laptop 250 G6 i3 7th Gen 4GB/1TB/15.6 inch/Windows 10 (5LR04PA),574,533,41,none,/hp-laptop-250-g6-i3-7th-gen-4gb-1tb-15-6-inch-windows-10-5lr04pa-CMPLXLAPHP-LAPTOP-25DUMM20256F9797689-pdp?product_id=281607932&src=consumer_search-grid&svc=-1&tracker=%7C%7C%7C%7C%2Fg%2Felectronics%2Flaptop-computers%2Flaptops-glpid-6453%7C6453%7C28%7C%7C%7C%7C&get_review_id=277349449
"Lenovo Ideapad S145 (AMD Ryzen Series R5 /4 GB DDR4/ 1 TB HDD /39.62 cm (15.6 inch) /Windows 10/MS Office 2019 Lifetime Validity) 81UT00J7IN (Grey, 1.85 Kg)",605,520,85,none,/lenovo-ideapad-s145-amd-ryzen-series-r5-4-gb-ddr4-1-tb-hdd-39-62-cm-15-6-inch-windows-10-81ut00j7in-grey-1-85-kg-CMPLXLAPLENOVO-IDEAPUNBO867328E6E78E89-pdp?product_id=328471177&src=consumer_search-grid&svc=-1&tracker=%7C%7C%7C%7C%2Fg%2Felectronics%2Flaptop-computers%2Flaptops-glpid-6453%7C6453%7C29%7C%7C%7C%7C&get_review_id=328673617
HP 250 G6 i3/7th gen/4GB/1TB/ 5XD48PA,531,486,45,none,/hp-250-g6-core-i3-6th-gen-4-gb-1-tb-15-6-dos-250-g6-4vt51pa-black-2-1-kg-CMPLXLAPHP-250-G6-COMOBI352353701DC99-pdp?product_id=227409301&src=consumer_search-grid&svc=-1&tracker=%7C%7C%7C%7C%2Fg%2Felectronics%2Flaptop-computers%2Flaptops-glpid-6453%7C6453%7C30%7C%7C%7C%7C&get_review_id=226049225
"Lenovo IdeaPad Slim 3i Intel Core i3 10th Gen 15.6"" FHD Thin and Light Laptop (8 GB/1 TB HDD/Windows10/MS Office/Platinum Grey/1.85Kg), 81WE007TIN",730,593,137,none,/lenovo-ideapad-slim-3i-intel-core-i3-10th-gen-15-6-fhd-thin-and-light-laptop-8-gb-1-tb-hdd-windows10-ms-office-platinum-grey-1-85kg-81we007tin-CMPLXLAPLENOVO-IDEAPUNBO8673289394E1FD-pdp?product_id=337077260&src=consumer_search-grid&svc=-1&tracker=%7C%7C%7C%7C%2Fg%2Felectronics%2Flaptop-computers%2Flaptops-glpid-6453%7C6453%7C31%7C%7C%7C%7C&get_review_id=331264766
"Lenovo Ideapad Slim 3i (Intel Core i3 - 10th Gen/ 4 GB RAM/ 1 TB HDD/ 39.62 cm (15.6 inch)/ Windows 10) 81WE0081IN (Platinum Grey , 1.85 kg)",740,534,206,none,/lenovo-ideapad-slim-3i-intel-core-i3-10th-gen-4-gb-ram-1-tb-hdd-39-62-cm-15-6-inch-windows-10-81we0081in-platinum-grey-1-85-kg-CMPLXLAPLENOVO-IDEAPDUMM20256D9E0BE3D-pdp?product_id=337222079&src=consumer_search-grid&svc=-1&tracker=%7C%7C%7C%7C%2Fg%2Felectronics%2Flaptop-computers%2Flaptops-glpid-6453%7C6453%7C32%7C%7C%7C%7C&get_review_id=330967799
"Lenovo V15 (AMD Ryzen 3- 3rd Gen/ 4 GB RAM/ 1 TB HDD/ 39.62 cm (15.6 inch) / Windows 10) 82C7001YIH (Iron Grey, 1.85 kg)",603,452,151,none,/lenovo-v15-amd-ryzen-3-3rd-gen-4-gb-ram-1-tb-hdd-39-62-cm-15-6-inch-windows-10-82c7001yih-iron-grey-1-85-kg-CMPLXLAPLENOVO-V15-AMY-S29032A426778A-pdp?product_id=337328514&src=consumer_search-grid&svc=-1&tracker=%7C%7C%7C%7C%2Fg%2Felectronics%2Flaptop-computers%2Flaptops-glpid-6453%7C6453%7C1%7C%7C%7C%7C&get_review_id=331060532
"Asus Vivobook X515JA-EJ301T Laptop (Intel Core i3-10th Gen 1005G1/4 GB RAM/1 TB HDD/39.62 cm (15.6 inch)/FHD/Windows 10 Home + McAfee/FingerPrint/ No ODD/Without Optical Drive) (Slate Grey, 1.9 kg)",562,473,89,none,/asus-vivobook-x515ja-ej301t-laptop-intel-core-i3-10th-gen-1005g1-4-gb-ram-1-tb-hdd-39-62-cm-15-6-inch-fhd-windows-10-home-+-mcafee-fingerprint-no-odd-without-optical-drive-slate-grey-1-9-kg-CMPLXLAPASUS-VIVOBOODUMM2025687229D68-pdp?product_id=337352406&src=consumer_search-grid&svc=-1&tracker=%7C%7C%7C%7C%2Fg%2Felectronics%2Flaptop-computers%2Flaptops-glpid-6453%7C6453%7C2%7C%7C%7C%7C&get_review_id=334938345
HP 250 G6(Core i3 7th Gen/4 GB/ 1 TB/(15.6 inch)/Windows 10)(Black 1.7 KG),568,547,21,none,/hp-250-g6-core-i3-7th-gen-4-gb-1-tb-15-6-inches-windows-10-black-1-7-kg-CMPLXLAPHP-250-G6-COK-S-7246355ABADC24-pdp?product_id=239668100&src=consumer_search-grid&svc=-1&tracker=%7C%7C%7C%7C%2Fg%2Felectronics%2Flaptop-computers%2Flaptops-glpid-6453%7C6453%7C3%7C%7C%7C%7C&get_review_id=239668103
Apple MacBook Pro with Touch Bar (Intel Core i5-10th Gen/16 GB/1 TB/33.02 cm (13 inch)/Mac OS) MWP52HN/A (Grey  1.4 kg),0,2670,-2670,none,/apple-macbook-pro-with-touch-bar-intel-core-i5-10th-gen-16-gb-1-tb-33-02-cm-13-inch-mac-os-mwp52hn-a-grey-1-4-kg-CMPLXLAPAPPLE-MACBOODUMM2025634258C26-pdp?product_id=337139294&src=consumer_search-grid&svc=-1&tracker=%7C%7C%7C%7C%2Fg%2Felectronics%2Flaptop-computers%2Flaptops-glpid-6453%7C6453%7C4%7C%7C%7C%7C&get_review_id=331160617
Dell Latitude 3410 Intel Core i5-10210U/4 GB/1 TB/ 14 inch HD/Backlit Keyboard /Dos/3yrs ADP+NBD),856,849,7,none,/dell-latitude-3410-intel-core-i5-10210u-4-gb-1-tb-14-inch-hd-backlit-keyboard-dos-3yrs-adp+nbd-CMPLXLAPDELL-LATITUDDUMM202567EF580EA-pdp?product_id=332777939&src=consumer_search-grid&svc=-1&tracker=%7C%7C%7C%7C%2Fg%2Felectronics%2Flaptop-computers%2Flaptops-glpid-6453%7C6453%7C5%7C%7C%7C%7C&get_review_id=332777940
Lenovo E41-45 Laptop (AMD A6-7350B/4 GB RAM/1 TB HDD/35.56 cm (14 inch)/DOS/AMD Integrated) 82BF000EIH (Black),541,349,192,none,/lenovo-e41-45-laptop-amd-a6-7350b-4-gb-ram-1-tb-hdd-35-56-cm-14-inch-dos-intel-integrated-82bf000eih-black-CMPLXLAPLENOVO-E41-4DUMM20256139F83F5-pdp?product_id=336918455&src=consumer_search-grid&svc=-1&tracker=%7C%7C%7C%7C%2Fg%2Felectronics%2Flaptop-computers%2Flaptops-glpid-6453%7C6453%7C6%7C%7C%7C%7C&get_review_id=334818108
"Asus VivoBook14 (Intel Core i3-10th Gen/4 GB RAM/256 GB SSD/35.56 cm (14 inch)/Windows 10) X415JA-EK312TS (Silver,1.6kg)",603,510,93,none,/asus-vivobook14-intel-core-i3-10th-gen-4-gb-ram-256-gb-ssd-35-56-cm-14-inch-windows-10-x415ja-ek312ts-silver-1-6kg-CMPLXLAPASUS-VIVOBOOASUS209152D0A5249-pdp?product_id=337107828&src=consumer_search-grid&svc=-1&tracker=%7C%7C%7C%7C%2Fg%2Felectronics%2Flaptop-computers%2Flaptops-glpid-6453%7C6453%7C7%7C%7C%7C%7C&get_review_id=337107830
"HP 250 G8 (Intel Core i3-11th Gen /4 GB RAM /1TB HDD/39.62 cm (15.6 inch)/Windows 10/Intel UHD Graphics) 3Y666PA (Dark Ash Silver, 1.74 Kg)",531,526,5,none,/hp-250-g8-intel-core-i3-11th-gen-4-gb-ram-1tb-hdd-39-62-cm-15-6-inch-windows-10-intel-uhd-graphics-3y666pa-dark-ash-silver-1-74-kg-CMPLXLAPHP-250-G8-INLOWE54147631E71809-pdp?product_id=337625401&src=consumer_search-grid&svc=-1&tracker=%7C%7C%7C%7C%2Fg%2Felectronics%2Flaptop-computers%2Flaptops-glpid-6453%7C6453%7C8%7C%7C%7C%7C&get_review_id=337360187
"Lenovo V15 AMD RYZEN 3 3250U 15.6-inch HD Laptop (4GB/1TB/DOS/Grey/1.85Kg),82C70016IH",469,384,85,none,/lenovo-v15-amd-ryzen-3-3250u-15-6-inch-hd-laptop-4gb-1tb-dos-grey-1-85kg-82c70016ih-CMPLXLAPLENOVO-V15-ADUMM20256DA4C6194-pdp?product_id=334754597&src=consumer_search-grid&svc=-1&tracker=%7C%7C%7C%7C%2Fg%2Felectronics%2Flaptop-computers%2Flaptops-glpid-6453%7C6453%7C9%7C%7C%7C%7C&get_review_id=334754598
"Asus ROG Zephyru (AMD Ryzen 7 8th Gen/ 16 GB RAM/ 512 GB SSD/ 35.56 cm (14 inch)/ Windows 10/ 6 GB Graphic Memory) G14 R7-4800HS (Moonlight White, 3 Kg) Anime Matrix/ Sleeve, Rog Eye Clip Webcam",2041,1630,411,none,/asus-rog-zephyru-amd-ryzen-7-8th-gen-16-gb-ram-512-gb-ssd-35-56-cm-14-inch-windows-10-6-gb-graphic-memory-g14-r7-4800hs-moonlight-white-3-kg-anime-matrix-sleeve-rog-eye-clip-webcam-CMPLXLAPASUS-ROG-ZEPASUS209156640DEB0-pdp?product_id=337973078&src=consumer_search-grid&svc=-1&tracker=%7C%7C%7C%7C%2Fg%2Felectronics%2Flaptop-computers%2Flaptops-glpid-6453%7C6453%7C10%7C%7C%7C%7C&get_review_id=337973080
"HP Pavilion 11th Gen Intel Core i5 Processor 15.6-inch FHD Laptop with Alexa Built-in (16GB/512GB SSD/Win 10/MS Offce/2GB NVIDIA MX450 Graphics/Natural Silver/1.75 Kg), 15-EG0103TX",1126,1022,104,none,/hp-pavilion-11th-gen-intel-core-i5-processor-15-6-inch-fhd-laptop-with-alexa-built-in-16gb-512gb-ssd-win-10-ms-offce-2gb-nvidia-mx450-graphics-natural-silver-1-75-kg-15-eg0103tx-CMPLXLAPHP-PAVILION-COMP37841BFBE5135-pdp?product_id=337184451&src=consumer_search-grid&svc=-1&tracker=%7C%7C%7C%7C%2Fg%2Felectronics%2Flaptop-computers%2Flaptops-glpid-6453%7C6453%7C11%7C%7C%7C%7C&get_review_id=337184453
Lenovo E41-45 Laptop (AMD A6-7350B/4 GB RAM/1 TB HDD/35.56 cm (14 inch)/ Windows 10 Home/AMD Integrated) 82BF000JIH (Black),475,315,160,none,/lenovo-e41-45-laptop-amd-a6-7350b-4-gb-ram-1-tb-hdd-35-56-cm-14-inch-windows-10-home-intel-integrated-82bf000jih-black-CMPLXLAPLENOVO-E41-4DUMM20256A112CB55-pdp?product_id=335439291&src=consumer_search-grid&svc=-1&tracker=%7C%7C%7C%7C%2Fg%2Felectronics%2Flaptop-computers%2Flaptops-glpid-6453%7C6453%7C12%7C%7C%7C%7C&get_review_id=334818105
"Asus VivoBook 15 (AMD Ryzen 5-3500U/4 GB DDR4 RAM/256 GB SSD/39.62 cm (15.6 inch)/FHD/Windows 10 Home + McAfee/Integrated AMD Vega 8 Graphics/Fingerprint Reader) M515DA-BQ521T (Slate Grey, 2.5 kg)",685,548,137,none,/asus-vivobook-15-amd-ryzen-5-3500u-4-gb-ddr4-ram-256-gb-ssd-39-62-cm-15-6-inch-fhd-windows-10-home-+-mcafee-integrated-amd-vega-8-graphics-fingerprint-reader-m515da-bq521t-slate-grey-2-5-kg-CMPLXLAPASUS-VIVOBOOASUS2091520ACEA32-pdp?product_id=337936584&src=consumer_search-grid&svc=-1&tracker=%7C%7C%7C%7C%2Fg%2Felectronics%2Flaptop-computers%2Flaptops-glpid-6453%7C6453%7C13%7C%7C%7C%7C&get_review_id=337936586
"HP 15 AMD Athlon 15.6-inch HD Laptop (Silver-3050U/4 GB/1 TB/Windows 10/MS Office/Jet Black/1.85 kg), 15s-gy0001au",417,370,47,none,/hp-15-amd-athlon-15-6-inch-hd-laptop-silver-3050u-4-gb-1-tb-windows-10-ms-office-jet-black-1-85-kg-15s-gy0001au-CMPLXLAPHP-15-AMD-ATDUMM20256FCF1710F-pdp?product_id=337222069&src=consumer_search-grid&svc=-1&tracker=%7C%7C%7C%7C%2Fg%2Felectronics%2Flaptop-computers%2Flaptops-glpid-6453%7C6453%7C14%7C%7C%7C%7C&get_review_id=337222070
"Lenovo V15 AMD RYZEN 3 3250U 15.6-inch HD Laptop (4GB/1TB/DOS/Grey/1.85Kg),82C7001WIH",589,405,184,none,/lenovo-v15-amd-ryzen-3-3250u-15-6-inch-hd-laptop-4gb-1tb-dos-grey-1-85kg-82c7001wih-CMPLXLAPLENOVO-V15-AGMCS31729918DF0063-pdp?product_id=337328497&src=consumer_search-grid&svc=-1&tracker=%7C%7C%7C%7C%2Fg%2Felectronics%2Flaptop-computers%2Flaptops-glpid-6453%7C6453%7C15%7C%7C%7C%7C&get_review_id=336215020
"Asus X515MA-EJ101T Laptop (Intel Pentium N5030/ 4GB Ram/ 1TB HDD/ 15.6"" FHD/ Windows 10 Home/ Transparent Silver/ No ODD, 1.9 kg) Without Optical Drive",452,355,97,none,/asus-x515ma-ej101t-laptop-intel-pentium-n5030-4gb-ram-1tb-hdd-15-6-fhd-windows-10-home-transparent-silver-no-odd-1-9-kg-without-optical-drive-CMPLXLAPASUS-X515MA-IT-P20603B7CEA5CC-pdp?product_id=336359625&src=consumer_search-grid&svc=-1&tracker=%7C%7C%7C%7C%2Fg%2Felectronics%2Flaptop-computers%2Flaptops-glpid-6453%7C6453%7C16%7C%7C%7C%7C&get_review_id=336359627
"ASUS VivoBook Ultra K14 (2020), Intel Core i5-1035G1 10th Gen, 14-Inch FHD (8GB RAM/512GB SSD/Windows 10/Integrated Graphics/Indie Black/1.4 kg), K413JA-EK285T",945,771,174,none,/asus-vivobook-ultra-k14-2020-intel-core-i5-1035g1-10th-gen-14-inch-fhd-8gb-ram-512gb-ssd-windows-10-integrated-graphics-indie-black-1-4-kg-k413ja-ek285t-CMPLXLAPASUS-VIVOBOODUMM2025678618085-pdp?product_id=336057174&src=consumer_search-grid&svc=-1&tracker=%7C%7C%7C%7C%2Fg%2Felectronics%2Flaptop-computers%2Flaptops-glpid-6453%7C6453%7C17%7C%7C%7C%7C&get_review_id=336057175
"Lenovo Ideapad Slim 3 AMD Ryzen 3 15.6 inch Full HD Thin and Light Laptop (4GB/1TB HDD/Windows 10/MS Office 2019/Integrated AMD Radeon Graphics/Platinum Grey/1.85Kg), 81W10057IN",527,404,123,none,/lenovo-ideapad-slim-3-amd-ryzen-3-15-6-inch-full-hd-thin-and-light-laptop-4gb-1tb-hdd-windows-10-ms-office-2019-integrated-amd-radeon-graphics-platinum-grey-1-85kg-81w10057in-CMPLXLAPLENOVO-IDEAPLOWE541476B6D2510F-pdp?product_id=336340939&src=consumer_search-grid&svc=-1&tracker=%7C%7C%7C%7C%2Fg%2Felectronics%2Flaptop-computers%2Flaptops-glpid-6453%7C6453%7C18%7C%7C%7C%7C&get_review_id=336339849
"Asus VivoBook Flip 14 (Intel Core i5-11th Gen/8 GB RAM/512 GB SSD/35.56 cm (14 inch)/Windows 10) TP470EZ-EC033TS (Transparent Silver,1.5kg)",1356,1059,297,none,/asus-vivobook-flip-14-intel-core-i5-11th-gen-8-gb-ram-512-gb-ssd-35-56-cm-14-inch-windows-10-tp470ez-ec033ts-transparent-silver-1-5kg-CMPLXLAPASUS-VIVOBOODUMM2025632DF63C8-pdp?product_id=337107838&src=consumer_search-grid&svc=-1&tracker=%7C%7C%7C%7C%2Fg%2Felectronics%2Flaptop-computers%2Flaptops-glpid-6453%7C6453%7C19%7C%7C%7C%7C&get_review_id=337107839
"Asus Gaming Laptop ROG Strix G17 i7-10750H (Intel Core i7 10th Gen/16 GB RAM/512 GB SSD + 512 GB SSD/43.94 cm (17.3 inch)/Graphics RTX2060-6GB/Windows 10 G712LV-EV004TS (Black, 2.24 Kg)",2452,1767,685,none,/asus-gaming-laptop-rog-strix-g17-i7-10750h-intel-core-i7-10th-gen-16-gb-ram-512-gb-ssd-+-512-gb-ssd-43-94-cm-17-3-inch-graphics-rtx2060-6gb-windows-10-g712lv-ev004ts-black-2-24-kg-CMPLXLAPASUS-GAMING-DUMM20256F69860B4-pdp?product_id=337936609&src=consumer_search-grid&svc=-1&tracker=%7C%7C%7C%7C%2Fg%2Felectronics%2Flaptop-computers%2Flaptops-glpid-6453%7C6453%7C20%7C%7C%7C%7C&get_review_id=337936610
"Asus Laptop Rog Zephyrus G14 GA401II-HE233TS R5-4600Hs/ 8 GB DDR4 Ram/ 512 GB DSSD/ 14 inch FHD-120Hz/ Backlit/ Wifi6/ 76Wh/ Windows 10/ Mso H&S 2019/ Gtx1650Ti-4 GB/ Moonlight White, 2.5 Kg",1712,1185,527,none,/asus-laptop-rog-zephyrus-g14-ga401ii-he233ts-r5-4600hs-8-gb-ddr4-ram-512-gb-dssd-14-inch-fhd-120hz-backlit-wifi6-76wh-windows-10-mso-h-s-2019-gtx1650ti-4-gb-moonlight-white-2-5-kg-CMPLXLAPASUS-LAPTOP-DUMM202561B02B3D1-pdp?product_id=337251563&src=consumer_search-grid&svc=-1&tracker=%7C%7C%7C%7C%2Fg%2Felectronics%2Flaptop-computers%2Flaptops-glpid-6453%7C6453%7C21%7C%7C%7C%7C&get_review_id=337251564
"Asus (Intel Core i5-10th Gen/8 GB RAM/512 GB SSD/39.62 cm (15.6 inch)/Windows 10) X515JF-EJ522TS (Transparent Silver,1.8kg)",931,760,171,none,/asus-intel-core-i5-10th-gen-8-gb-ram-512-gb-ssd-39-62-cm-15-6-inch-windows-10-x515jf-ej522ts-transparent-silver-1-8kg-CMPLXLAPASUS-INTEL-CDUMM20256580C6326-pdp?product_id=337107817&src=consumer_search-grid&svc=-1&tracker=%7C%7C%7C%7C%2Fg%2Felectronics%2Flaptop-computers%2Flaptops-glpid-6453%7C6453%7C22%7C%7C%7C%7C&get_review_id=337107818
"ASUS VivoBook Ultra K14 (2020), Intel Core i5-1035G1 10th Gen, 14-Inch FHD (8GB RAM/512GB SSD/Windows 10/Integrated Graphics/Transparent Silver/1.4 kg), K413JA-EK286T",945,767,178,none,/asus-vivobook-ultra-k14-2020-intel-core-i5-1035g1-10th-gen-14-inch-fhd-8gb-ram-512gb-ssd-windows-10-integrated-graphics-transparent-silver-1-4-kg-k413ja-ek286t-CMPLXLAPASUS-VIVOBOOASUS209155BE7504E-pdp?product_id=336057188&src=consumer_search-grid&svc=-1&tracker=%7C%7C%7C%7C%2Fg%2Felectronics%2Flaptop-computers%2Flaptops-glpid-6453%7C6453%7C23%7C%7C%7C%7C&get_review_id=336057190
"Asus  ROG Zephyrus S15 (Intel Core i7-10th Gen/16 GB RAM/1 TB SSD/39.62 cm (15.6 inch)/ Windows 10) GX502LXS-HF050T (Black , 3 kg)",4082,3244,838,none,/asus-rog-zephyrus-s15-intel-core-i7-10th-gen-16-gb-ram-1-tb-ssd-39-62-cm-15-6-inch-windows-10-gx502lxs-hf050t-black-3-kg-CMPLXLAPASUS-ROG-ZEPDUMM20256F0BE3FE0-pdp?product_id=335734209&src=consumer_search-grid&svc=-1&tracker=%7C%7C%7C%7C%2Fg%2Felectronics%2Flaptop-computers%2Flaptops-glpid-6453%7C6453%7C24%7C%7C%7C%7C&get_review_id=335734210
"Asus ROG Strix G15 (Intel Core i7-10870H/16 GB RAM/512 GB SSD + 512 GB SSD/39.62 cm (15.6 inch)/FHD/Windows 10 Home/NVIDIA Geforce RTX 2060-6 GB Graphics) G512LV-HN222T (Black, 2.5 kg)",2041,1756,285,none,/asus-rog-strix-g15-intel-core-i7-10870h-16-gb-ram-512-gb-ssd-+-512-gb-ssd-39-62-cm-15-6-inch-fhd-windows-10-home-nvidia-geforce-rtx-2060-6-gb-graphics-g512lv-hn222t-black-2-5-kg-CMPLXLAPASUS-ROG-STRDUMM202565BD6C75F-pdp?product_id=336612594&src=consumer_search-grid&svc=-1&tracker=%7C%7C%7C%7C%2Fg%2Felectronics%2Flaptop-computers%2Flaptops-glpid-6453%7C6453%7C25%7C%7C%7C%7C&get_review_id=336612595
"Asus VivoBook 14  (Intel Core i3-10th Gen/8 GB RAM/1 TB HDD + 128 GB SSD/35.56 cm (14 inch)/Windows 10) X415JA-EK331T (Slate Grey,1.6kg)",685,551,134,none,/asus-vivobook-14-intel-core-i3-10th-gen-8-gb-ram-1-tb-hdd-+-128-gb-ssd-35-56-cm-14-inch-windows-10-x415ja-ek331t-slate-grey-1-6kg-CMPLXLAPASUS-VIVOBOOASUS20915760B7747-pdp?product_id=337107819&src=consumer_search-grid&svc=-1&tracker=%7C%7C%7C%7C%2Fg%2Felectronics%2Flaptop-computers%2Flaptops-glpid-6453%7C6453%7C26%7C%7C%7C%7C&get_review_id=337107826
"Asus VivoBook Ultra 15 (Intel Core i3-11th Gen/8 GB RAM/256 GB SSD/39.62 cm (15.6 inch)/Windows 10) X513EA-BQ312TS (Star Black,1.8kg)",753,619,134,none,/asus-vivobook-ultra-15-intel-core-i3-11th-gen-8-gb-ram-256-gb-ssd-39-62-cm-15-6-inch-windows-10-x513ea-bq312ts-star-black-1-8kg-CMPLXLAPASUS-VIVOBOOASUS20915E43156C3-pdp?product_id=337107831&src=consumer_search-grid&svc=-1&tracker=%7C%7C%7C%7C%2Fg%2Felectronics%2Flaptop-computers%2Flaptops-glpid-6453%7C6453%7C27%7C%7C%7C%7C&get_review_id=337107833
"Asus ExpertBook (Intel Core i5-10th Gen/4 GB DDR4 RAM/1 TB HDD/35.56 cm (14 inch)/DOS/Integrated Graphics) P1440FA-FQ2350 (Black, 2 Kg)",815,568,247,none,/asus-expertbook-intel-core-i5-10th-gen-4-gb-ddr4-ram-1-tb-hdd-35-56-cm-14-inch-dos-integrated-graphics-p1440fa-fq2350-black-2-kg-CMPLXLAPASUS-EXPERTBDUMM2025614607438-pdp?product_id=337979263&src=consumer_search-grid&svc=-1&tracker=%7C%7C%7C%7C%2Fg%2Felectronics%2Flaptop-computers%2Flaptops-glpid-6453%7C6453%7C28%7C%7C%7C%7C&get_review_id=337979264
"Asus Vivobook (Intel Core i3-10th Gen/8 GB DDR4 RAM/1 TB HDD + 256 GB SSD/39.62 cm (15.6 inch)/Windows 10/Integrated Graphics) X515JA-EJ511T (Grey, 1.7 Kg)",849,705,144,none,/asus-vivobook-intel-core-i3-10th-gen-8-gb-ddr4-ram-1-tb-hdd-+-256-gb-ssd-39-62-cm-15-6-inch-windows-10-integrated-graphics-x515ja-ej511t-grey-1-7-kg-CMPLXLAPASUS-VIVOBOODUMM20256C745E415-pdp?product_id=337979257&src=consumer_search-grid&svc=-1&tracker=%7C%7C%7C%7C%2Fg%2Felectronics%2Flaptop-computers%2Flaptops-glpid-6453%7C6453%7C29%7C%7C%7C%7C&get_review_id=337979258
"Asus ROG Zephyrus S15 (2020) (Intel Core i7-10th Gen/32 GB DDR4 RAM/1 TB SSD/39.62 cm (15.6 inch)/Windows 10/8 GB Graphics) GX502LWS-HF120T (Black, 1.9 Kg)",3767,2479,1288,none,/asus-rog-zephyrus-s15-2020-intel-core-i7-10th-gen-32-gb-ddr4-ram-1-tb-ssd-39-62-cm-15-6-inch-windows-10-8-gb-graphics-gx502lws-hf120t-black-1-9-kg-CMPLXLAPASUS-ROG-ZEPDUMM20256A5930BA8-pdp?product_id=337979254&src=consumer_search-grid&svc=-1&tracker=%7C%7C%7C%7C%2Fg%2Felectronics%2Flaptop-computers%2Flaptops-glpid-6453%7C6453%7C30%7C%7C%7C%7C&get_review_id=337979256
"Asus  Vivo Book S S14 (Intel Core i5-11th Gen/8 GB RAM/512 GB SSD + 32 GB Optane/35.56 cm (14 inch)/ Windows 10) S433EA-AM502TS (Dreamy White , 1.4 kg)",1233,930,303,none,/asus-vivo-book-s-s14-intel-core-i5-11th-gen-8-gb-ram-512-gb-ssd-+-32-gb-optane-35-56-cm-14-inch-windows-10-s433ea-am502ts-dreamy-white-1-4-kg-CMPLXLAPASUS-VIVO-BOASUS2091598D0A48C-pdp?product_id=335734202&src=consumer_search-grid&svc=-1&tracker=%7C%7C%7C%7C%2Fg%2Felectronics%2Flaptop-computers%2Flaptops-glpid-6453%7C6453%7C31%7C%7C%7C%7C&get_review_id=335734205
"Asus ROG Strix G17 (Intel Core i7-10750H/16 GB RAM/512 GB SSD + 512 GB SSD/43.94 cm (17.3 inch)/FHD/Windows 10 Home/NVIDIA Geforce GTX 1660Ti-6 GB Graphics) G712LU-EV008TS (Black, 2.5 kg)",2219,1479,740,none,/asus-rog-strix-g17-intel-core-i7-10750h-16-gb-ram-512-gb-ssd-+-512-gb-ssd-43-94-cm-17-3-inch-fhd-windows-10-home-nvidia-geforce-gtx-1660ti-6-gb-graphics-g712lu-ev008ts-black-2-5-kg-CMPLXLAPASUS-ROG-STRDUMM20256FF79FC1B-pdp?product_id=336612591&src=consumer_search-grid&svc=-1&tracker=%7C%7C%7C%7C%2Fg%2Felectronics%2Flaptop-computers%2Flaptops-glpid-6453%7C6453%7C32%7C%7C%7C%7C&get_review_id=336612592
Acer Aspire 3 UN.HF9SI.039 Ryzen 3 Dual Core 3200U - (4 GB/1 TB HDD/Windows 10 Home) A315-42 Laptop  (15.6 inch  Black  1.9 kg),479,386,93,none,/acer-aspire-3-un-hf9si-039-ryzen-3-dual-core-3200u-4-gb-1-tb-hdd-windows-10-home-a315-42-laptop-15-6-inch-black-1-9-kg-CMPLXLAPACER-ASPIRE-DUMM20256E95A1CC3-pdp?product_id=336496008&src=consumer_search-grid&svc=-1&tracker=%7C%7C%7C%7C%2Fg%2Felectronics%2Flaptop-computers%2Flaptops-glpid-6453%7C6453%7C1%7C%7C%7C%7C&get_review_id=336496009
"ASUS TUF Gaming F15 Laptop (Intel Core i7-10870H/16GB RAM/1TB SSD/39.62 cm (15.6 inch)/FHD/Windows 10/NVIDIA Geforce GTX 1660Ti 6 GB Graphics/MS Office H&S 2019) FX506LU-HN161TS (Bonfire Black, 3 kg)",1807,1466,341,none,/asus-tuf-gaming-f15-laptop-intel-core-i7-10870h-16gb-ram-1tb-ssd-39-62-cm-15-6-inch-fhd-windows-10-nvidia-geforce-gtx-1660ti-6-gb-graphics-ms-office-h-s-2019-fx506lu-hn161ts-bonfire-black-3-kg-CMPLXLAPASUS-TUF-GAMDUMM20256A17F8687-pdp?product_id=337947127&src=consumer_search-grid&svc=-1&tracker=%7C%7C%7C%7C%2Fg%2Felectronics%2Flaptop-computers%2Flaptops-glpid-6453%7C6453%7C2%7C%7C%7C%7C&get_review_id=337947128
"HP 15-db1059au Thin and Light Laptop (AMD Ryzen 3-3200U/4 GB DDR4 RAM/1 TB HDD/39.62 cm (15.6 inch)/Windows 10/MS Office 2019/AMD Radeon Vega 3 Graphics) (Natural Silver, 1.8 kg)",503,445,58,none,/hp-15-db1059au-thin-and-light-laptop-amd-ryzen-3-3200u-4-gb-ddr4-ram-1-tb-hdd-39-62-cm-15-6-inch-windows-10-ms-office-2019-amd-radeon-vega-3-graphics-natural-silver-1-8-kg-CMPLXLAPHP-15-DB1059DUMM20256A8FAD9A-pdp?product_id=335590875&src=consumer_search-grid&svc=-1&tracker=%7C%7C%7C%7C%2Fg%2Felectronics%2Flaptop-computers%2Flaptops-glpid-6453%7C6453%7C3%7C%7C%7C%7C&get_review_id=335590876
"Lenovo V15 (AMD RYZEN 3-2nd Gen(4 GB RAM/1TB HDD/39.62 cm (15.6 inch)/DOS) 82C7001WIH (Iron Grey,1.85Kg)",469,392,77,none,/lenovo-v15-amd-ryzen-3-2nd-gen-4-gb-ram-1tb-hdd-39-62-cm-15-6-inch-dos-82c7001wih-iron-grey-1-85kg-CMPLXLAPLENOVO-V15-AINDI23886891E5F3B-pdp?product_id=337128460&src=consumer_search-grid&svc=-1&tracker=%7C%7C%7C%7C%2Fg%2Felectronics%2Flaptop-computers%2Flaptops-glpid-6453%7C6453%7C4%7C%7C%7C%7C&get_review_id=336188420
"ASUS TUF Gaming F17 (Intel Core i5-10300H/8 GB RAM/512 GB SSD/43.94 cm (17.3 inch)/Windows 10/FHD/RGB Backlit/ WIFI6/ 48Wh/NVIDIA Geforce GTX 1650Ti 4 GB Graphics) FX766LI-HX185T (Fortress Gray, 3 kg)",1384,1048,336,none,/asus-tuf-gaming-f17-intel-core-i5-10300h-8-gb-ram-512-gb-ssd-43-94-cm-17-3-inch-windows-10-fhd-rgb-backlit-wifi6-48wh-nvidia-geforce-gtx-1650ti-4-gb-graphics-fx766li-hx185t-fortress-gray-3-kg-CMPLXLAPASUS-TUF-GAMDUMM20256F332EB07-pdp?product_id=337962064&src=consumer_search-grid&svc=-1&tracker=%7C%7C%7C%7C%2Fg%2Felectronics%2Flaptop-computers%2Flaptops-glpid-6453%7C6453%7C5%7C%7C%7C%7C&get_review_id=337962065
"HP Pavilion x360 Core i3 11th Gen - (8 GB/512 GB SSD/Windows 10 Home) 14-dw1037TU 2 in 1 Laptop  (14 inch, Natural Silver, 1.61 kg, With MS Office)",902,740,162,none,/hp-pavilion-x360-core-i3-11th-gen-8-gb-512-gb-ssd-windows-10-home-14-dw1037tu-2-in-1-laptop-14-inch-natural-silver-1-61-kg-with-ms-office-CMPLXLAPHP-PAVILION-MOBI22943BB5504BF-pdp?product_id=336797287&src=consumer_search-grid&svc=-1&tracker=%7C%7C%7C%7C%2Fg%2Felectronics%2Flaptop-computers%2Flaptops-glpid-6453%7C6453%7C6%7C%7C%7C%7C&get_review_id=336335805
"Lenovo IdeaPad Slim 5 Thin and Light Laptop (AMD Ryzen 7-4700U/8 GB/512 GB SSD/35.56 cm (14 inch)/FHD/Windows 10/Office 2019/AMD Radeon Graphics/Fingerprint Reader) 81YM002TIN (Graphite Grey, 1.39 kg)",1164,904,260,none,/lenovo-ideapad-slim-5-thin-and-light-laptop-amd-ryzen-7-4700u-8-gb-512-gb-ssd-35-56-cm-14-inch-fhd-windows-10-office-2019-amd-radeon-graphics-fingerprint-reader-81ym002tin-graphite-grey-1-39-kg-CMPLXLAPLENOVO-IDEAPLOWE541476D2ACE959-pdp?product_id=337328498&src=consumer_search-grid&svc=-1&tracker=%7C%7C%7C%7C%2Fg%2Felectronics%2Flaptop-computers%2Flaptops-glpid-6453%7C6453%7C7%7C%7C%7C%7C&get_review_id=335458131
"Asus Vivobook (AMD Ryzen 5 - 3rd Gen / 8 GB RAM / 1 TB HDD / 39.62 cm (15.6 inch) / Windows 10) M515DA-BQ501T (Slate Grey , 2.5 kg)",698,574,124,none,/asus-vivobook-amd-ryzen-5-3rd-gen-8-gb-ram-1-tb-hdd-39-62-cm-15-6-inch-windows-10-m515da-bq501t-slate-grey-2-5-kg-CMPLXLAPASUS-VIVOBOODUMM202569AC2BF03-pdp?product_id=337251479&src=consumer_search-grid&svc=-1&tracker=%7C%7C%7C%7C%2Fg%2Felectronics%2Flaptop-computers%2Flaptops-glpid-6453%7C6453%7C8%7C%7C%7C%7C&get_review_id=337251480
"HP Pavilion x360 (Intel Core i5-10th Gen (8 GB RAM/512 GB SSD/35.56 cm (14 inch)/Windows 10 Home) dw0069TU (Natural Silver, 1.61 kg)",1096,1021,75,none,/hp-pavilion-x360-intel-core-i5-10th-gen-8-gb-ram-512-gb-ssd-35-56-cm-14-inch-windows-10-home-dw0069tu-natural-silver-1-61-kg-CMPLXLAPHP-PAVILION-GADG486872B8B1B0C-pdp?product_id=336341139&src=consumer_search-grid&svc=-1&tracker=%7C%7C%7C%7C%2Fg%2Felectronics%2Flaptop-computers%2Flaptops-glpid-6453%7C6453%7C9%7C%7C%7C%7C&get_review_id=336341141
Lenovo IdeaPad Gaming 3i 10th Gen Intel Core i5 15.6-inch FHD IPS Laptop (8 GB/1 TB HDD + 256 GB SSD/Windows 10/NVIDIA GTX 1650Ti 4 GB GDDR6 Graphics/Onyx Black/2.2 Kg) 81Y400VBIN,1507,945,562,none,/lenovo-ideapad-gaming-3i-10th-gen-intel-core-i5-15-6-inch-fhd-ips-laptop-8-gb-1-tb-hdd-+-256-gb-ssd-windows-10-nvidia-gtx-1650ti-4-gb-gddr6-graphics-onyx-black-2-2-kg-81y400vbin-CMPLXLAPLENOVO-IDEAPWOTH2624684DD80740-pdp?product_id=337267872&src=consumer_search-grid&svc=-1&tracker=%7C%7C%7C%7C%2Fg%2Felectronics%2Flaptop-computers%2Flaptops-glpid-6453%7C6453%7C10%7C%7C%7C%7C&get_review_id=337267874
"Asus VivoBook Ultra 15 (Intel Core i3-11th Gen/8 GB RAM/256 GB SSD/39.62 cm (15.6 inch)/Windows 10) X513EA-BQ313TS (Dreamy White,1.8kg)",753,612,141,none,/asus-vivobook-ultra-15-intel-core-i3-11th-gen-8-gb-ram-256-gb-ssd-39-62-cm-15-6-inch-windows-10-x513ea-bq313ts-dreamy-white-1-8kg-CMPLXLAPASUS-VIVOBOOASUS20915FEE56F23-pdp?product_id=337107821&src=consumer_search-grid&svc=-1&tracker=%7C%7C%7C%7C%2Fg%2Felectronics%2Flaptop-computers%2Flaptops-glpid-6453%7C6453%7C11%7C%7C%7C%7C&get_review_id=337107827
"HP 240 G8 Laptop (Intel Core i3-1005G1(10th Gen)/4 GB DDR4 RAM/1 TB HDD/35.56 cm (14 inch)/HD/DOS/Intel HD Graphics) 3D0J1PA (Grey, 1.8 kg)",505,464,41,none,/hp-240-g8-laptop-intel-core-i3-1005g1-10th-gen-4-gb-ddr4-ram-1-tb-hdd-35-56-cm-14-inch-hd-dos-intel-hd-graphics-3d0j1pa-grey-1-8-kg-CMPLXLAPHP-240-G8-LADUMM202561C3B43E3-pdp?product_id=337847006&src=consumer_search-grid&svc=-1&tracker=%7C%7C%7C%7C%2Fg%2Felectronics%2Flaptop-computers%2Flaptops-glpid-6453%7C6453%7C12%7C%7C%7C%7C&get_review_id=337847007
"ASUS ROG Zephyrus Duo 15, 15.6 inch FHD 300Hz/3ms, Intel Core i7-10875H 10th Gen, RTX 2070 Super Max-Q 8GB Graphics, Gaming Laptop (32 GB/1 TB SSD/Windows 10/MS Office/Grey), GX550LWS-HF079TS",4986,2712,2274,none,/asus-rog-zephyrus-duo-15-15-6-inch-fhd-300hz-3ms-intel-core-i7-10875h-10th-gen-rtx-2070-super-max-q-8gb-graphics-gaming-laptop-32-gb-1-tb-ssd-windows-10-ms-office-grey-gx550lws-hf079ts-CMPLXLAPASUS-ROG-ZEPASUS20915AB761E2C-pdp?product_id=337344197&src=consumer_search-grid&svc=-1&tracker=%7C%7C%7C%7C%2Fg%2Felectronics%2Flaptop-computers%2Flaptops-glpid-6453%7C6453%7C13%7C%7C%7C%7C&get_review_id=337344199
"ASUS ROG Strix G17 (2021), 17.3 inch FHD 300Hz/3ms, AMD Ryzen 9 5900HX, GeForce RTX 3060 6GB Graphics, Gaming Laptop (16GB/1TB SSD/Office 2019/Windows 10/Eclipse Grey/2.7 kg), G713QM-HG074TS",2945,2315,630,none,/asus-rog-strix-g17-2021-17-3-inch-fhd-300hz-3ms-amd-ryzen-9-5900hx-geforce-rtx-3060-6gb-graphics-gaming-laptop-16gb-1tb-ssd-office-2019-windows-10-eclipse-grey-2-7-kg-g713qm-hg074ts-CMPLXLAPASUS-ROG-STRASUS20915FDCAD04F-pdp?product_id=337952596&src=consumer_search-grid&svc=-1&tracker=%7C%7C%7C%7C%2Fg%2Felectronics%2Flaptop-computers%2Flaptops-glpid-6453%7C6453%7C14%7C%7C%7C%7C&get_review_id=337952598
"Asus  Vivo Book S13  (Intel Core i5-11th Gen/8 GB RAM/512 GB SSD/33.78 cm (13.3 inch)/ Windows 10) S333EA-EG501TS (Grey , 1.5 kg)",1082,836,246,none,/asus-vivo-book-s13-intel-core-i5-11th-gen-8-gb-ram-512-gb-ssd-33-78-cm-13-3-inch-windows-10-s333ea-eg501ts-grey-1-5-kg-CMPLXLAPASUS-VIVO-BODUMM20256F08684A7-pdp?product_id=335734215&src=consumer_search-grid&svc=-1&tracker=%7C%7C%7C%7C%2Fg%2Felectronics%2Flaptop-computers%2Flaptops-glpid-6453%7C6453%7C15%7C%7C%7C%7C&get_review_id=335734216
"Asus X515MA-EJ001T Laptop (Intel Celeron N4020 Processor / 4GB RAM / 1TB HDD / 15.6"" FHD / Windows 10 Home / No ODD / Transparent Silver) Without Optical Drive",397,342,55,none,/asus-vivobook-intel-celeron-10th-gen-4-gb-ram-1-tb-hdd-windows-10-x515ma-ej001t-transparent-silver-2-2-kg-CMPLXLAPASUS-VIVOBOOASUS20915A53D1286-pdp?product_id=337608183&src=consumer_search-grid&svc=-1&tracker=%7C%7C%7C%7C%2Fg%2Felectronics%2Flaptop-computers%2Flaptops-glpid-6453%7C6453%7C16%7C%7C%7C%7C&get_review_id=337419549
"ASUS ROG Zephyrus Duo 15, 15.6 inch FHD 300Hz/3ms, Intel Core i7-10875H 10th Gen, RTX 2070 Super Max-Q 8GB Graphics, Gaming Laptop (32 GB/1 TB SSD/Office 2019/Windows 10/Grey), GX550LWS-HF130TS",4945,2658,2287,none,/asus-rog-zephyrus-duo-15-15-6-inch-fhd-300hz-3ms-intel-core-i7-10875h-10th-gen-rtx-2070-super-max-q-8gb-graphics-gaming-laptop-32-gb-1-tb-ssd-office-2019-windows-10-grey-gx550lws-hf130ts-CMPLXLAPASUS-ROG-ZEPASUS209155CC4FDAB-pdp?product_id=337344200&src=consumer_search-grid&svc=-1&tracker=%7C%7C%7C%7C%2Fg%2Felectronics%2Flaptop-computers%2Flaptops-glpid-6453%7C6453%7C17%7C%7C%7C%7C&get_review_id=337344202
"Asus ROG Strix G15 (Intel Core i7-10870H/8 GB/1TB SSD/39.62 cm (15.6 inch)/FHD/Windows 10/RGB Backlit/NumberPad/NVIDIA Geforce GTX 1650Ti 4 GB Graphics/MS Office H&S 2019) G512LI-HN274TS (Black, 3 kg)",1685,1301,384,none,/asus-rog-strix-g15-intel-core-i7-10870h-8-gb-1tb-ssd-39-62-cm-15-6-inch-fhd-windows-10-rgb-backlit-numberpad-nvidia-geforce-gtx-1650ti-4-gb-graphics-ms-office-h-s-2019-g512li-hn274ts-black-3-kg-CMPLXLAPASUS-ROG-STRASUS20915B670F2AD-pdp?product_id=337962066&src=consumer_search-grid&svc=-1&tracker=%7C%7C%7C%7C%2Fg%2Felectronics%2Flaptop-computers%2Flaptops-glpid-6453%7C6453%7C18%7C%7C%7C%7C&get_review_id=337962068
"ASUS TUF Gaming A15 (2021) (AMD Ryzen 7 10th Gen/16 GB/1 TB SSD/Office 2019/Windows 10/GeForce RTX 3060 6GB Graphics) FA566QM-HN087TS (Eclipse Grey, 2.3 kg)",2123,1642,481,none,/asus-tuf-gaming-a15-2021-amd-ryzen-7-10th-gen-16-gb-1-tb-ssd-office-2019-windows-10-geforce-rtx-3060-6gb-graphics-fa566qm-hn087ts-eclipse-grey-2-3-kg-CMPLXLAPASUS-TUF-GAMDUMM20256447547B6-pdp?product_id=337978531&src=consumer_search-grid&svc=-1&tracker=%7C%7C%7C%7C%2Fg%2Felectronics%2Flaptop-computers%2Flaptops-glpid-6453%7C6453%7C19%7C%7C%7C%7C&get_review_id=337978532
"Asus Vivobook (AMD Ryzen 5 - 3rd Gen / 8 GB RAM / 512 GB SSD / 39.62 cm (15.6 inch) / Windows 10) M515DA-EJ512TS (Silver , 2.5 kg)",781,651,130,none,/asus-vivobook-amd-ryzen-5-3rd-gen-8-gb-ram-512-gb-ssd-39-62-cm-15-6-inch-windows-10-m515da-ej512ts-silver-2-5-kg-CMPLXLAPASUS-VIVOBOOASUS2091543943632-pdp?product_id=337251481&src=consumer_search-grid&svc=-1&tracker=%7C%7C%7C%7C%2Fg%2Felectronics%2Flaptop-computers%2Flaptops-glpid-6453%7C6453%7C20%7C%7C%7C%7C&get_review_id=337251483
"ASUS ROG Zephyrus G14 Ultra Slim Gaming (AMD Ryzen 5 8th Gen/8 GB RAM/ 512 GB SSD/ 35.56 cm (14 Inch) FHD/Window 10/ 4 GB Graphics) GA401II-HE234TS (Eclipse Grey, 3 Kg) Sleeve, Rog Eye Clip Webcam",1685,1212,473,none,/asus-rog-zephyrus-g14-ultra-slim-gaming-amd-ryzen-5-8th-gen-8-gb-ram-512-gb-ssd-35-56-cm-14-inch-fhd-window-10-4-gb-graphics-ga401ii-he234ts-eclipse-gray-3-kg-sleeve-rog-eye-clip-webcam-CMPLXLAPASUS-ROG-ZEPASUS209151CA9BBE8-pdp?product_id=337952702&src=consumer_search-grid&svc=-1&tracker=%7C%7C%7C%7C%2Fg%2Felectronics%2Flaptop-computers%2Flaptops-glpid-6453%7C6453%7C21%7C%7C%7C%7C&get_review_id=337952704
"Asus P1411CJA-EK360 Laptop (Core i3-10th Gen 1005G1 / 4GB Ram / 1TB HDD / 14"" FHD / OS Endless / Slate Grey / No ODD) Without Optical Drive",479,425,54,none,/asus-p1411cja-ek360-laptop-intel-core-i3-10th-gen-10110u-2-1ghz-4-gb-ddr4-ram-1-tb-hdd-35-56-cm-14-inch-fhd-dos-fingerprint-no-odd-without-optical-drive-slate-grey-1-8-kg-CMPLXLAPASUS-P1411CJDUMM2025663569AE3-pdp?product_id=337594999&src=consumer_search-grid&svc=-1&tracker=%7C%7C%7C%7C%2Fg%2Felectronics%2Flaptop-computers%2Flaptops-glpid-6453%7C6453%7C22%7C%7C%7C%7C&get_review_id=337595000
"Asus VivoBook 15 (AMD Ryzen 5-8th Gen (8 GB RAM / 1 TB HDD/ 39.62 cm (15.6 inch) / Windows 10) M515DA-BQ502TS (Silver , 1.75 kg)",726,596,130,none,/asus-vivobook-15-amd-ryzen-5-8th-gen-8-gb-ram-1-tb-hdd-39-62-cm-15-6-inch-windows-10-m515da-bq502ts-silver-1-75-kg-CMPLXLAPASUS-VIVOBOOASUS209156E44BE26-pdp?product_id=337973095&src=consumer_search-grid&svc=-1&tracker=%7C%7C%7C%7C%2Fg%2Felectronics%2Flaptop-computers%2Flaptops-glpid-6453%7C6453%7C23%7C%7C%7C%7C&get_review_id=337973097
"Asus VivoBook14 (Intel Core i3-10th Gen/8 GB RAM/1 TB HDD + 128 GB SSD/35.56 cm (14 inch)/Windows 10)  X415JA-EK092TS (Silver,1.6kg)",685,595,90,none,/asus-vivobook14-intel-core-i3-10th-gen-8-gb-ram-1-tb-hdd-+-128-gb-ssd-35-56-cm-14-inch-windows-10-x415ja-ek092ts-silver-1-6kg-CMPLXLAPASUS-VIVOBOODUMM202562C1A3F20-pdp?product_id=337107822&src=consumer_search-grid&svc=-1&tracker=%7C%7C%7C%7C%2Fg%2Felectronics%2Flaptop-computers%2Flaptops-glpid-6453%7C6453%7C24%7C%7C%7C%7C&get_review_id=337107823
"ASUS ZenBook (Intel Core i5-1135G7/8GB LPDDR4X RAM/512GB NVMe PCIe SSD/35.56 cm (14 inch)/FHD TouchScreen/Windows 10/MS Office/Integrated Graphics) UX482EA-KA501TS (Celestial Blue, 1.62 kg)",1603,1438,165,none,/asus-zenbook-intel-core-i5-1135g7-8gb-lpddr4x-ram-512gb-nvme-pcie-ssd-35-56-cm-14-inch-fhd-touchscreen-windows-10-ms-office-integrated-graphics-ux482ea-ka501ts-celestial-blue-1-62-kg-CMPLXLAPASUS-ZENBOOKUNBO867328CB0B4EDB-pdp?product_id=337223392&src=consumer_search-grid&svc=-1&tracker=%7C%7C%7C%7C%2Fg%2Felectronics%2Flaptop-computers%2Flaptops-glpid-6453%7C6453%7C25%7C%7C%7C%7C&get_review_id=337223197
"ASUS ZenBook Duo (Intel Core i5-10th Gen/8 GB RAM/512GB NVMe SSD/35.56 cm (14 inch)/FHD/Windows 10/2GB NVIDIA GeForce MX250 Graphics/ScreenPad Plus) UX481FL-BM5811T (Celestial Blue, 1.5 kg)",1533,1164,369,none,/asus-zenbook-duo-intel-core-i5-10th-gen-8-gb-ram-512gb-nvme-ssd-35-56-cm-14-inch-fhd-windows-10-2gb-nvidia-geforce-mx250-graphics-screenpad-plus-ux481fl-bm5811t-celestial-blue-1-5-kg-CMPLXLAPASUS-ZENBOOKASUS2091513C130E1-pdp?product_id=337962250&src=consumer_search-grid&svc=-1&tracker=%7C%7C%7C%7C%2Fg%2Felectronics%2Flaptop-computers%2Flaptops-glpid-6453%7C6453%7C26%7C%7C%7C%7C&get_review_id=337962252
"Asus ROG Zephyrus G (AMD Ryzen 7-10th Gen/16 GB DDR4 RAM/512 GB SSD/39.62 cm (15.6 inch)/Windows 10/6 GB Graphics) GA502DU-AZ083T (Black, 2.1 Kg)",1712,1301,411,none,/asus-rog-zephyrus-g-amd-ryzen-7-10th-gen-16-gb-ddr4-ram-512-gb-ssd-39-62-cm-15-6-inch-windows-10-6-gb-graphics-ga502du-az083t-black-2-1-kg-CMPLXLAPASUS-ROG-ZEPASUS20915B7596BFE-pdp?product_id=337979265&src=consumer_search-grid&svc=-1&tracker=%7C%7C%7C%7C%2Fg%2Felectronics%2Flaptop-computers%2Flaptops-glpid-6453%7C6453%7C27%7C%7C%7C%7C&get_review_id=337979267
"Asus  Vivo Book S15 (Intel Core i5-11th Gen/8 GB RAM/512 GB SSD/39.62 cm (15.6 inch)/ Windows 10) S532EQ-BQ502TS (Silver , 2.5 kg)",1137,1034,103,none,/asus-vivo-book-s15-intel-core-i5-11th-gen-8-gb-ram-512-gb-ssd-39-62-cm-15-6-inch-windows-10-s532eq-bq502ts-silver-2-5-kg-CMPLXLAPASUS-VIVO-BOASUS20915D05B2AF3-pdp?product_id=335734220&src=consumer_search-grid&svc=-1&tracker=%7C%7C%7C%7C%2Fg%2Felectronics%2Flaptop-computers%2Flaptops-glpid-6453%7C6453%7C28%7C%7C%7C%7C&get_review_id=335734222
"Asus ROG Zephyrus (16 GB RAM/ 512 GB SSD/ 35.56 cm (14 inch)/Windows 10) GA401IU-HA247TS (Eclipse Grey, 3 Kg)",2178,1589,589,none,/asus-rog-zephyrus-16-gb-ram-512-gb-ssd-35-56-cm-14-inch-windows-10-ga401iu-ha247ts-eclipse-grey-3-kg-CMPLXLAPASUS-ROG-ZEPASUS209152C4787D7-pdp?product_id=336406072&src=consumer_search-grid&svc=-1&tracker=%7C%7C%7C%7C%2Fg%2Felectronics%2Flaptop-computers%2Flaptops-glpid-6453%7C6453%7C29%7C%7C%7C%7C&get_review_id=336406074
"Asus X515JA-EJ302TS (Intel Core i3- 10th Gen/ 4 GB RAM/1 TB HDD/39.62 cm (15.6 inch)/FHD/Windows 10/MS Office 2019) (Transparent Silver, 1.6 kg)",589,493,96,none,/asus-x515ja-ej302ts-intel-core-i3-10th-gen-4-gb-ram-1-tb-hdd-39-62-cm-15-6-inch-fhd-windows-10-transparent-silver-1-6-kg-CMPLXLAPASUS-X515JA-REAL40006C249DE01-pdp?product_id=337221809&src=consumer_search-grid&svc=-1&tracker=%7C%7C%7C%7C%2Fg%2Felectronics%2Flaptop-computers%2Flaptops-glpid-6453%7C6453%7C30%7C%7C%7C%7C&get_review_id=335470141
"Asus Vivobook (AMD Ryzen 5-3500U 2.1 GHz/ 8GB DDR4/ 1TB HDD/ 15.6""FHD/ AMD Radeon Vega 8 Graphics/ Windows 10 Home/ Slate Grey/ 1.6 Kg) M415DA-EB501T",698,603,95,none,/asus-vivobook-amd-ryzen-5-3500u-2-1-ghz-8gb-ddr4-1tb-hdd-15-6-fhd-amd-radeon-vega-8-graphics-windows-10-home-slate-grey-1-6-kg-m415da-eb501t-CMPLXLAPASUS-VIVOBOODUMM20256B3CD7AA7-pdp?product_id=337317389&src=consumer_search-grid&svc=-1&tracker=%7C%7C%7C%7C%2Fg%2Felectronics%2Flaptop-computers%2Flaptops-glpid-6453%7C6453%7C31%7C%7C%7C%7C&get_review_id=336057187
ASUS ExpertBook P1 P1510 Intel Core i5-1035G1/ 10th Gen/ 1TB/ 8 GB DDR4 /15.6 inch/ DOS/ WIFI5 /P1510CJA-EJ402 (Star Black),685,589,96,none,/asus-expertbook-p1-p1510-intel-core-i5-1035g1-10th-gen-1tb-8-gb-ddr4-15-6-inch-dos-wifi5-p1510cja-ej402-star-black-CMPLXLAPASUS-EXPERTBDUMM202569887BCDE-pdp?product_id=336057011&src=consumer_search-grid&svc=-1&tracker=%7C%7C%7C%7C%2Fg%2Felectronics%2Flaptop-computers%2Flaptops-glpid-6453%7C6453%7C32%7C%7C%7C%7C&get_review_id=336057012
"Lenovo IdeaPad S145 10th Gen Intel Core i5 15.6-inch Full HD Thin and Light Laptop (8GB/1TB HDD/Windows 10/MS Office 2019/Platinum Grey/1.85Kg), 81W800TEIN",877,712,165,none,/lenovo-ideapad-s145-10th-gen-intel-core-i5-15-6-inch-full-hd-thin-and-light-laptop-8gb-1tb-hdd-windows-10-ms-office-2019-platinum-grey-1-85kg-81w800tein-CMPLXLAPLENOVO-IDEAPUNBO8673289E0E543E-pdp?product_id=337328510&src=consumer_search-grid&svc=-1&tracker=%7C%7C%7C%7C%2Fg%2Felectronics%2Flaptop-computers%2Flaptops-glpid-6453%7C6453%7C1%7C%7C%7C%7C&get_review_id=336360578
"Asus ExpertBook P2 (Intel Core i5-10th Gen/8 GB DDR4 RAM/1 TB HDD/35.56 cm (14 inch)/DOS/2 GB Graphics) P2451FB-EK0058 (Silver, 1.6 Kg)",952,719,233,none,/asus-expertbook-p2-intel-core-i5-10th-gen-8-gb-ddr4-ram-1-tb-hdd-35-56-cm-14-inch-dos-2-gb-graphics-p2451fb-ek0058-silver-1-6-kg-CMPLXLAPASUS-EXPERTBDUMM202562EF81D66-pdp?product_id=337979261&src=consumer_search-grid&svc=-1&tracker=%7C%7C%7C%7C%2Fg%2Felectronics%2Flaptop-computers%2Flaptops-glpid-6453%7C6453%7C2%7C%7C%7C%7C&get_review_id=337979262
"HP 15 Thin & Light 15.6-inch FHD Laptop (Ryzen 3 3250U/8GB/1TB HDD/Win 10 Home/MS Office/1.76 Kg/Natural Silver), 15s-gr0011AU",545,485,60,none,/hp-15-thin-light-15-6-inch-fhd-laptop-ryzen-3-3250u-8gb-1tb-hdd-win-10-home-ms-office-1-76-kg-natural-silver-15s-gr0011au-CMPLXLAPHP-15-THIN-LCOMP37841CBF76647-pdp?product_id=337765592&src=consumer_search-grid&svc=-1&tracker=%7C%7C%7C%7C%2Fg%2Felectronics%2Flaptop-computers%2Flaptops-glpid-6453%7C6453%7C3%7C%7C%7C%7C&get_review_id=335593302
"Asus Vivobook (AMD Ryzen 3-3250U 2.6 GHz/ 4GB DDR4/ 1TB HDD/ 15.6""FHD/ AMD Radeon Integrated Graphics/ Windows 10 Home/Slate Grey/ 1.8 Kg) M515DA-EJ301T",520,418,102,none,/asus-vivobook-amd-ryzen-3-3250u-2-6-ghz-4gb-ddr4-1tb-hdd-15-6-fhd-amd-radeon-integrated-graphics-windows-10-home-slate-grey-1-8-kg-m515da-ej301t-CMPLXLAPASUS-VIVOBOODUMM2025683B48735-pdp?product_id=336057177&src=consumer_search-grid&svc=-1&tracker=%7C%7C%7C%7C%2Fg%2Felectronics%2Flaptop-computers%2Flaptops-glpid-6453%7C6453%7C4%7C%7C%7C%7C&get_review_id=336057178
"Lenovo IdeaPad Slim 3 (AMD Athlon Silver 3050U/4 GB RAM/1 TB HDD/39.62 cm (15.6 inch)/HD/Windows 10/MS Office 2019/Integrated AMD Radeon Graphics) 81W100W9IN (Platinum Grey, 1.85 kg)",589,411,178,none,/lenovo-ideapad-slim-3-amd-athlon-silver-3050u-4-gb-ram-1-tb-hdd-39-62-cm-15-6-inch-hd-windows-10-ms-office-2019-integrated-amd-radeon-graphics-81w100w9in-platinum-grey-1-85-kg-CMPLXLAPLENOVO-IDEAPDUMM20256DA10D7D7-pdp?product_id=337328508&src=consumer_search-grid&svc=-1&tracker=%7C%7C%7C%7C%2Fg%2Felectronics%2Flaptop-computers%2Flaptops-glpid-6453%7C6453%7C5%7C%7C%7C%7C&get_review_id=336298956
"ASUS Core i5 10th Gen - (8 GB RAM/512 GB SSD/Windows 10 Home/4 GB Graphics/McAfee(1 Year)/Xbox Game Pass(30 Days)) FX566LI-BQ265T  (15.6 inch, Fortress Gray, 3 kg)",1226,938,288,none,/asus-core-i5-10th-gen-8-gb-ram-512-gb-ssd-windows-10-home-4-gb-graphics-mcafee-1-year-xbox-game-pass-30-days-fx566li-bq265t-15-6-inch-fortress-gray-3-kg-CMPLXLAPASUS-CORE-I5DUMM20256827DECAD-pdp?product_id=337974511&src=consumer_search-grid&svc=-1&tracker=%7C%7C%7C%7C%2Fg%2Felectronics%2Flaptop-computers%2Flaptops-glpid-6453%7C6453%7C6%7C%7C%7C%7C&get_review_id=337974512
"Lenovo IdeaPad S340 Thin and Light Laptop (Intel Core i5-10th Gen/8 GB/512 GB SSD/35.56 cm (14 inch)/FHD/Windows 10/MS Office 2019/NVIDIA MX230 2GB GDDR5 Graphics) 81WJ004JIN (Platinum Grey, 1.6 kg)",1197,781,416,none,/lenovo-ideapad-s340-thin-and-light-laptop-intel-core-i5-10th-gen-8-gb-512-gb-ssd-35-56-cm-14-inch-fhd-windows-10-ms-office-2019-nvidia-mx230-2gb-gddr5-graphics-81wj004jin-platinum-grey-1-6-kg-CMPLXLAPLENOVO-IDEAPDUMM2025627B77B91-pdp?product_id=337455873&src=consumer_search-grid&svc=-1&tracker=%7C%7C%7C%7C%2Fg%2Felectronics%2Flaptop-computers%2Flaptops-glpid-6453%7C6453%7C7%7C%7C%7C%7C&get_review_id=335458137
